abed	 寝床に(in bed) 
abet	 (特に悪い事に)…'を'扇動する,そそのかす《+『名』+『in』+『名』(do『ing』)》 
able	 《補語にのみ用いて》《『be able to』 do》(…することが)『できる』 / 『有能な』,腕ききの,並々ならない
ably	 りっぱに,うまく 
abut	 (…に)接する,隣接する《+『on』(『upon』,『onto』)+『名』》 / (他の建物に)よりかかる《+『against』+『名』》
ache	 (継続的に鈍く)〈人が〉『痛みを感じる』,〈身体が〉痛む,うずく / 《話》切望する,心から願う / 《しばしば複合語を作って》(継続的な鈍い)『痛み』,うずき 
acid	 酸性の / 酸味のある,すっぱい(sour) / (言葉・態度などが)厳しい,しんらつな / 酸 / すっぱいもの / 《俗》=LSD
acme	 《the ~》(…の)絶頂,極致(peak)《+『of』+『名』》 
acne	 にきび(pimple) 
acre	 『エーカー』(面積の単位;約4,047平方メートル) / 《複数形で》田畑,土地
adze	 (材木をけずる)手おの 
aery	 =ethereal 
aged	 《補語にのみ用い,数詞を伴って》…『歳の』 / (酒・チーズなどが)熟成した
ague	 マラリア熱,おこり / 寒け,悪寒
ahem	 えへん(人の注意を引いたり,警告・疑いなどを表して,わざとするせき払いの声) 
ahoy	 おおい(船乗りが遠方に呼びかける声) 
aide	 副官(aide-de-camp) / 補佐官,助手
airy	 風のよく通る(あたる) / (物が)軽やかな,ふんわりした;(動きが)軽やかな / 浮き浮きした,陽気な / 空想的な;非現実的な
akin	 (…と)同じ家族の,血族の《+『to』+『名』》 / (…と)類似の,同類の《+『to』+『名』》
alit	 alightの過去・過去分詞 
alms	 施し物,義援金 
aloe	 アロエ,ロカイ(南アフリカ原産の薬用・観賞用のユリ科の植物) / 《米》リュウゼツラン(American aloe) / 《複数形で》《単数扱い》沈香(じんこう)(香料) 
also	 …『もまた』(too),やはり / そしてその上,それから
alto	 〈U〉アルト,中高音(おもに女性の最低音;以前は男性の高音も意味した) / 〈C〉アルト歌手;アルト音域の楽器 / アルトの 
alum	 みょうばん(明礬) 
amen	 アーメン(ヘブライ語でcertainly(たしかに)の意.ギリシア語,ラテン語を通して英語にはいってきたもので,「そうなってください」(So be it!またはMay it be so!)という意味.キリスト教徒はお祈りや賛美歌のあとにとなえる) 
amid	 …の中に;…のまっさい中に 
amir	 =emir 
amok	 =amuck 
anew	 《文》新たに,再び 
anis	 アニス酒(aniseedで味をつける) 
ankh	 (エジプト美術で)輪つき十字形(生殖・長寿の象徴) 
ante	 アンティ(ポーカーで新しい札を引く前に出すかけ金) / 《俗》分け前
anti	 《話》(特定の慣習・政策・行動などに)反対する人 
anus	 肛門(こうもん) 
apex	 頂上,頂点 / 《文》最高潮,絶頂
apse	 後陣(教会堂の東端に張り出した半円形または多角形の部分) 
arch	 (建物の)『アーチ』,迫持(せりもち) / アーチ型の記念碑,弓形門 / 『弓形のもの』 / (足の)土踏まず / …'を'弓形にする / …‘に'アーチをかける / 弓形になる,弓状に伸びる 
arid	 (土地などが)乾燥した,不毛の / (本・話などが)つまらない,無味乾燥な
arms	兵器, 武器, 火器
army	 《ときにA-》『陸軍』 / 《the A-》軍隊;(一国の全)軍隊 / (共通の主義・主張のために組織された)(…の)『団体』,集団《+『of』+『名』》 / (人・動物などの)大群《+『of』+『名』》
arse	 =ass
arty	 芸術家気どりの / 芸術品まがいの
ashy	 灰の / 灰のような;青白い
atom	 『原子』 / 微量,非常な少量;《a~》微量,わずか(の…)《+『of』+『名』》
atop	 …の上に / (…の)上に,頂上に《+『of』+『名』》
aunt	 『おば』 / おばさん(年長の婦人に対する敬称)
auto	 《米話》=automobile 
aver	 …'を'断言する,主張する;(…である)‘と'断言する《+『that節』》 
avid	 どん欲な 
avow	 …'を'率直に言う,率直に認める 
awry	 曲がって,ゆがんで,ねじれて / (目的・期待から)それて,まちがって / 曲がった;それた / まちがった,誤った
axes	 ax, axeの複数形 
axis	 〈C〉軸,軸線;枢軸(すうじく) / 《the A-》枢軸国(第二次大戦当時の日本・ドイツ・イタリアなど)
axle	 (車輪の)心棒 / =axletree
back	 〈C〉(人・動物の)『背』,『背中』,背部 / 《通例the~》(正面に対して)(…の)『後ろ』,『裏』,奥,後部《+『of』+『名』》 / 《通例the back》背に似たもの;(手足の)甲;(刀の)みね;(いす・本の)背 / 〈C〉〈U〉(フットボール・ホッケーなどの)後衛 / 《名詞の前にのみ用にて》『後ろの』,後部にある,裏の / 後もどりする,逆の / 遅れている,未払いの / (中心から)遠い,へんぴな,奥地の / (音声が)後舌音の / 『後方へ』,『後ろに』(backward) / (場所・状態が)『もとへ』,帰って,返して / (時間的に)『さかのぼって』,今から…前に(ago) / 〈車など〉'を'『後退させる』 / (…で)〈人・計画など〉'を'『後援する』,支持する(support)《+『名』+『in』+『名』》 / (競馬で)…に賭ける / (…で)…‘の'伴奏をする《+『名』+『by』+『名』》 / …‘の'裏手にある,背景をなす / 〈手形など〉‘に'裏書きする(endorse) / 《しばしば受動態で》〈本〉‘に'背をつける,(…で)…'を'裏打ちする《+『名』+『with』+『名』》 / 後ずさりする,後退する(move backward)
bade	 bidの過去形 
bags	 たくさん(…の)《+『of』+『名』》 / (博性用,また一般に)だぶだぶのズボン
bail	 保釈;保釈金;〈C〉保釈保証人 / (保釈金を払って)…'を'保釈出所させる《+『名』+『out,』+『out』+『名』》
bait	 〈U〉〈C〉(つり針・わなに仕掛ける)『餌』(え),『えさ』 / 〈C〉おとり,わな,誘惑 / 〈つり針・わな〉‘に'えさをつける / …‘に'犬をけしかける / 〈人〉'を'いじめる,なぶる 
bake	 (特にオーブンで)〈食物〉'を'『焼く』,焼いて料理する / 〈れんがなど〉'を'焼き固める;〈太陽が〉…'を'焦がす / (日にあたって)〈皮膚など〉'を'焼く / 〈パンなどが〉焼ける;〈人が〉パンを焼く / 〈土地・人などが〉日に焼ける 
bald	 (頭が)『はげた』,(人が)『はげ頭の』 / (山に樹木がなくて)裸の,(木に)葉のない / (文体など)単調な,飾りのない / あからさまな,露骨な;隠し立てのない
bale	 (輸送または貯蔵用に包装した))…の)大包み,こり,俵《+『of』+『名』》 / …'を'こりにする,俵に入れる
balm	 香油・芳香 / 〈U〉〈C〉鎮痛剤;(心の)慰め
band	 『帯』,『バンド』,ひも,(おけの)たが / (色の)すじ,しま / 周波数 / …‘に'バンドを付ける
bane	 害毒;破滅のもと 
bang	 バン(ドカン,ズドン,バタン)という音 / バン(ドン)という一撃(強打) / 《話》活力,気力 / …'を'『バン(ドン)と打つ』;(…に)…'を'バン(ドン)と打ちつける《+『名』+『on』(『against』『,at』)『+『名』》;〈戸など〉'を'バタンとしめる / 『バン(ドン)と音を立てる』;(…を)ドン(バン)と打つ《+『on』(『against』,『at』+『名』》/性交する（相手は女）  / まさに,全く,ちょうど
bank	 『土手』,堤 / 川岸;《複数形で》(川の)両岸 / (土手のように)長く盛り上がったもの / 州(す),浅瀬 / (丘などの,通例けわしい)傾斜面,坂 / (飛行機が施回するときの)傾斜 / |'を'土手で囲う(守る) / …‘に'土手を築く / …'を'土手のように積み上げる《+『up』+『名,』+『名』+『up』》 / (長くもたせるために)〈火〉‘に'灰をかぶせる《+『up』+『名,』+『名』+『up』》 / 〈機体・車体〉'を'横に傾ける / 積み重なる,層を成す《+『up』》 / 〈車・飛行機が〉横に傾く 
bard	 ケルト族の吟遊詩人 / (一般に)詩人
bare	 『裸の』,『おおいのない』;露出した,むき出した / 『からの』,なにもない(empty) / 『ありのままの』,赤裸々な / 《名詞の前にのみ用いて》『かろうじての』,やっとの;ただ…だけの(mere) / …'を'裸にする,あらわにする;〈刀〉'を'燃く 
bark	 木の皮,樹皮 / 〈木〉‘の'皮をはぐ / …'を'樹皮でおおう / …‘の'皮膚をすりむく
barn	 (農家の)『納家』(なや),物置 / 《米》家畜小屋(家畜・飼料を収容する大きな建物で,映画館ほどの大きさのものもある) / 《米》電車(バス)車庫 / ばかでかくてがらんとした建物
base	 《文》(人や人の行動・孝えが)『卑しい』,下劣な / (金属が)質の劣った;(貨幣が)粗悪な
bash	 …'を'ぶんなぐる,強く打つ《+『名』+『in』(『up』),+『in』(『up』)+『名』》 / 強打
bask	 (日光で)暖まる《+『in』+『名』》 / (愛情・恩恵などに)浴する,恵まれる《+『in』+『名』》
bast	 靱皮(じんぴ)繊維(植物の木質部の繊維でなわやかごの原料) 
bate	 …'を'減らす,減ずる,弱める 
bath	 『入浴』;水浴び / (また《おもに米》『bathtub』,《話》『tub』)浴槽(よくそう),ふろ[がま] / 『浴室』(bathroom); / 《複数形で》(古代の)大浴場 / (化学作用を与えるための)浴液;電解そう / …'を'入浴させる / 入浴する 
bats	 気の狂った 
bawd	 売春宿のおかみ / 売春婦
bawl	 叫ぶ,どなる《+『away』》 / 泣きわめく / どなる,わめく / 〈品物〉'を'呼び売りする / 叫び,わめき声 
bead	 『ビーズ』,『じゅず玉』,ガラス玉;《複数形で》じゅず(rosary),ネックレス / (玉のような)露,しずく / (銃の)照星,ねらい / …'を'玉で飾る;…'を'じゅずつなぎにする / 〈水などが〉玉(しずく)となる 
beak	 『くちばし』(通例ワシ・タカなどの曲がった,またカメ・タコなどのような角状のもの) / くちばし状のもの;(人の)かぎ鼻,(水差しの)口 / (昔の戦艦の)船嘴(せんし) 
beam	 〈C〉(建設の)『はり』,『けた』,横材 / 〈C〉(船の甲板を支える)横はり / 〈C〉(はかりの)さお;(織機の)糸巻き / 〈C〉『光線』,光束 / 〈C〉(顔などの)『輝き』,晴れやかさ / 〈C〉(船舶・航空機用の)信号電波 / 〈U〉最大船幅 / 《副詞[句]を伴って》『輝く』,光を発する / (…に)顔を輝かせる《+『at』(『on, upon』)+『名』》 / 〈光・熱〉'を'出す,発散する / (…に向けて)〈放送・無線信号〉'を'送る《+『名』+『at』(『to』)+『名』》 / …'を'顔を輝かせて言う
bean	 『豆』(おもにいんげん豆・そら豆など大きめの豆類) / 豆のさや(pod) / 豆に似た実 / 《俗》頭 / 《俗》(野球で)ビーンボールを投げる 
bear	 〈C〉『クマ』 / 〈C〉乱暴者 / 〈C〉(株式で)売り方 / 《the B-》クマ座
beat	 (連続して)…'を'『たたく』,打つ(pound) / (…に)…'を'『たたきつける』,打ちつける《+『名』+『against』+『名』》 / (…に)…'を'たたいて作る《+『名』+『into』+『名』》;〈金属〉'を'打ち延ばす / …'を'勢いよくかき混ぜる / 〈リズム・拍子〉'を'手をたたいて(手を振って,足を踏んで)とる / 〈道〉'を'踏み固めて作る / 《話》〈人〉'を'困らせる,まいらせる / 〈風・雨・波などが〉(…に)『打ちつける』,〈人が〉(…を)ドンドン打つ《+『at』(『against』,『in』,『on』)+『名』》 / 〈心臓・脈が〉鼓動する,脈打つ / ドンドン鳴る / 〈船が〉風に逆らってジグザグに進む / 『続けて打つこと』,連打 / (心臓などの)鼓動 / (警官などの)巡回(担当)区域,持ち場 / 拍子;手拍子,足拍子 / =beatnik / 《補語にのみ用いて》《俗》疲れはてた,へとへとになった / 《名詞の前にのみ用いて》《話》ビート族の
beau	 男友達,ボーイフレンド / しゃれ男;色男
beck	 うなずき;手招き 
belt	 『ベルト』,バンド,帯 / (特徴のある)地帯,地方 / (機械の)ベルト / ベルト状のもの / 《話》ピシャリとたたくと / …'を'ベルトで締めてつける《+『名』+『on,』+『on』+『名』》 / …'を'ベルトで巻く;(ベルトで締めるように)…'を'取り巻く《+『名』+『up,』+『up』+『名』》 / (革帯などで)…'を'打つ,たたく / 《話》…'を'ぶんなぐる 
bema	 聖堂内陣 / ユダヤ教の会堂内にある壇
bend	 〈まっすぐな物〉'を'『曲げる』 / (…に)〈人〉'を'『従わせる』,屈服させる,〈意志〉'を'曲げさせる《+『名』+『to』+『名』》 / (…の方向に)〈視線・歩みなど〉'を'『向ける』,〈心など〉'を'傾ける《+『名』+『to』(『toward』,『on』)+『名/(do『ing』)》 / 〈物が〉曲がる / 身をかがめる;(…に)かがみこむ《+[『down』]『over』+『名』》 / (運命・意志,人などに)『従う』,屈服する《+『before』(『to』)+『名』》 / (…を方向に)『曲がる』,向かう《+『to』(『toward』)+『名』》 / (仕事などに)取り組む,身を入れる《+『to』+『名』》 / 曲がり,湾曲部,曲がった所 / (…を)曲げる(曲がる)こと,(身を)かがめること《+『of』+『名』》 / (綱の)結び目 / 《話》《the bends》ケーソン病,潜水病
bent	 bendの過去・過去分詞 / 曲がった / 《補語にのみ用いて》(…の)決心をした,(…に)熱中した《+on+名(doing)》 / 《英俗》不正直な / (…に対する)性癖,性向,好み《+for+名》 
berg	 氷山(icebergの短縮形) 
berk	 (特に男の)まぬけ,とんま 
best	 (『good』の最上級;比較級は『better』)『いちばんよい』,最もよい,最良の / (『well』の最上級;比較級は『better』)『健康状態が最良の』(healthiest) / 最大の,大部分の / 《話》(反語的に)きわめてひどい,徹底した / (『well』の最上級;比較級は『better』)『いちばんよく』,最もよく,最も / 《通例過去分詞と結合して形容詞を作って》最もよく / 『最上』,最善,最良;最もすぐれた人々(物) / (…の)『最もよいもの』(部分)《+『of』+『名』》
beta	 ベータ(ギリシア語アルファベットの第2文字;Β,β;英語のB,b に遭当) 
bevy	 (少女・婦人,小ジカ・小鳥などの)群れ,一団《+『of』+『名』》 
bias	 〈C〉(布地の裁断や縫い目の)斜線,バイアス / 〈C〉〈U〉(…に対する)心理的傾向,性癖;先入観;偏見《+『toward』(『against』,『for』)+『名』》 / 斜めの;斜めに裁った / (…に対して)〈人〉‘に'偏見を抱かせる,〈人の意見・心〉'を'一方に片寄らせる / 《+『名』+『against』(『towards, in favor of』)+『名』》 
bide	とどまる; 住む; 待つ/こらえる, 我慢する.
bier	 (棺を載せる)棺台 
bike	 =bicycle 
bile	 胆汁(たんじゅう) / かんしゃく;不きげん
bilk	 〈勘定・借金など〉'を'踏み倒す / …をぺてんにかける,欺く
bind	 (ひもで)…'を'『しばる』,'を'束ねる《+『up+『名』,+『名』+『up』》 / (旨で)旨'を'『巻く』《+『名』+『with』+『名』》;〈包帯など〉'を'巻きつける《+『up』+『名』,+『名』+『up』》 / 《しばし受動熊で》〈人〉'を'『束縛する』,‘に'義務を負わせる / (氷・セメントなどで)…'を'固める,凝結させる《+『名』+『with』+『名』》 / 〈人〉'を'年季奉公に出す,徒弟(とてい)に出す / 〈本〉'を'とじる,製本する,装丁する / 〈衣服が〉…'を'窮屈にする,締めつける / 〈織物など〉‘に'へりをつける,縁飾りをつける / 〈土・砂などが〉固まる,締まる / 拘束する,拘束力がある / 〈衣服が〉窮屈である / 厄介な事態
biog	 biographical / biography / biographer 
bird	 『鳥』 / 〈話〉《修飾語を伴なって(目立った特徴をもった)やつ,人 / =shuttlecock / 《英俗》女 / 《俗》《the bird》(分満を表す)しーっしーっという野次《形容詞的に》『bird feathers』{名}鳥の羽『bird life』{名}〈U〉鳥の生活 
biro	 =ballpoint pen 
bite	 …'を'『かむ』,かじる,くわえる / 〈虫が〉…'を'刺す,食う / 〈こしょうなどが〉…'を'刺激する;〈寒さが〉…‘に'しみる;〈霜が〉…'を'いためる;〈酸が〉…'を'腐食す / る / 〈歯車や機械などが〉…‘に'かみ合う;〈刃物などが〉…‘に'切り(食い)込む / かむ;かみつく;〈魚が〉えさに食いつく / 〈寒さが〉しみる;〈こしょうなどが〉刺激する;〈言葉などが〉(…に)食い込む《+『into』+『名』) / (歯車などが)かみ合う,空回りしない / 『かむこと』,食いつくこと;(釣りで,魚の)食い / 〈C〉(食べ物の)1口[分]《+『of』+『名』》;《話》軽い食事 / 〈C〉かみ傷,(虫などの)刺した跡 / 〈U〉ぴっとする刺激;辛み;(傷の)痛み;激痛 / 〈U〉(機械などの)かみ合い 
bled	 bleedの過去・過去分詞 
blew	 blowの過去形 
blip	 レーダースクリーンの映像 / ピッという音
bloc	 ブロック,圏(地理・共通の利害・政治・経済上の目的などのために団結した団体・国家などの結合体) 
blot	 (特に,インクなどの)汚れ,しみ / (人格・名声などにつけられた)汚点,汚名 / 〈他〉…‘に'しみおつける,'を'汚す / (吸取紙で)…‘の'汚れ(しみ)を吸い取る;〈汚れ・しみ〉'を'吸い取る
blow	 〈風が〉『吹く』 / 《副詞[句]を伴って》(…に)風(空気)を送る,吹きつける《+at(on)+名》 / 『風で動く』,なびく,吹き飛ぶ / 〈オルガン・笛・らっぱが〉鳴る / (壊れて,だめになって)吹っ飛ぶ《+『out』》 / 〈クジラが〉潮を吹く / 《副詞[句]を伴って》〈風が〉…'を'『吹く』,吹き動かす,‘に'吹きつける,〈人が〉…'を'吹く,吹き払う / …'を'吹き鳴らす / …'を'吹いて作る(ふくらませる) / 〈鼻〉'を'かむ / (爆発・故障で)…'を'吹き飛ばす / (無器用に・むちゃくちゃにやって)…'を'吹き飛ばしてなくす / 《命令形または受動態で,いまいましい気持ちを表して》 / 一吹き;《話》さっと吹く風 / (楽器の)吹奏 / (クジラの)潮吹き
blue	 『青い』,あい色の / 青黒い / 《話》陰気な,憂うつな / 〈U〉『青色』,あい色;青色の着物 / 〈U〉〈C〉青色絵の具,あい色染料 / 《the~》《詩》青空,青い海 / 《the blues》《話》気のふさぎ,うれいの色 / 《the blues》《ときに単数扱い》(ジャズ音楽の)ブルース / …'を'青色にする 
blur	 にじみ;しみ,汚れ / 不鮮明;かすみ,曇り / (…で)…'を'汚す《+『名』+『with』+『名』》 / …'を'ぼんやりさせる,曇らす
boar	 (去勢しない)雄ブタ / =wild boar
boat	 『小型の船』,小舟,ボート / 《話》(大小に関係なく一般に)船,汽船 / 舟形の容器 / 舟に乗る / …'を'舟で運ぶ 
bode	 …‘の'前兆となる,'を'予言する 
body	 〈C〉『身体』,肉体 / 〈C〉(人・動物の)『胴体』 / 〈C〉)物の)『主要部』,本体《+『of』+『名』》 / 〈C〉(…の)『団体』,群れ:(…のたくさんの)集まり《+『of』+『名』》 / 〈C〉物体,…体 / 〈U〉実質;(酒・味などの)こく / 〈C〉《話》人 
bogy	 おばけ,幽霊 / 人の悩ますもの,人につきまとうもの
boil	 沸く / 煮える / 〈人,人の気持が〉(怒り・興奮で)煮えくりかえる,激する《+『with』+『名』》 / (沸騰する湯のように)わき立つ / …'を'『沸かす』 / …'を'『煮る』,ゆでる / 煮沸,沸騰;《the ~》沸騰点 
bola	 2個以上の鉄玉付きの投げなわ;(おもに南米南部で,獣の脚に投げつけ,からませて捕える道具) 
bold	 『大胆な,恐れを知らない』(fearless) / ずぶとい,ずうずうしい / 太くて目立つ;(文字が)肉太の / けわしい
bole	 木の幹 
bolt	 『ボルト』(木・鉄板を締め合わせる締めくぎ) / (戸締まりの)『かんぬき』,差し錠 / 石弓(crossbow)用の短く太い矢 / 『いなずま』,電光 / 《単数形で》(突然の)脱走,逃亡 / (布・紙の)一巻き《+『of』+『名』》 / 《米》脱党 / 〈戸・窓など〉‘に'かんぬきを掛ける;…'を'かんぬきを掛けて閉じ込める / 《米》…‘と'関係を絶つ / 〈食べ物〉'を'うのみにする,大急ぎで食べる / 急に飛び出す,急に駆け出す / まっすぐに
bond	 〈C〉『縛る物』 / 《通例複数形で》『束縛』,拘束,かせ / 《しばしば複数形で》(血縁,義理などの)『きずな』,縁 / 〈C〉契約 / 〈C〉『証書』,証文;『債券』,公債 / 〈U〉(石・れんがなどの)つなぎ方,組積み / 〈U〉保税倉庫入り / 〈U〉接着,接合;接着剤,接合剤 / 〈品物〉'を'担保とする / …‘の'保証人となる / (債券などを発行して)…‘の'支払いを保証する / …'を'つなぐ,結ぶ(bind together) / つながる 
bone	 〈C〉骨 / 〈U〉骨を作っている物質,骨質 / 《複数形で》骨格;死骸(がい) / 〈魚など〉‘の'骨を取る
bong	 (つり鐘などの)ゴーン[という音] / 〈つり鐘などが〉ゴーンを鳴る
bony	 骨の,骨のような / 骨の多い
bore	 bear（実をつける）の過去形 
born	 bear〈他〉1の過去分詞(受動態にのみ用いる) / 《名詞の前にのみ用いて》『生まれながらの』,先天的な(innate) / 『生まれた』;生じた 
bort	 (工業用の低質の)ダイヤモンドくず 
bosh	 《おもに英俗》ばかげたこと,たわごと / ばかな,くだらない
both	 『両方の』,双方の / 『両方』,両者 / 《『both』…『and』…の形で》『両方とも』,…のいずれも 
bout	 一試合,一勝負 / (…している)一時的な期間;(…の)発作(fit)《+『of』+『名』》
bowl	 『どんぶり,はち;わん』,茶わん,ボール / どんぶり(はち)1杯の量 / (…の)丸くくぼんだ部分《+『of』+『名』》 / 《米》(はち形の)円形競技場(stadium)
boxy	 箱に似た,箱のような 
brad	 (細くて頭の小さい)鉄線くぎ,折れくぎ 
brae	 《スコットランド》丘の側面,山腹 
brag	 (…を)自慢する《+『of』(『about』)+『名』(do『ing』)》 / 《『brag』+『that』節》…'を'自慢する / 〈C〉自慢の種 / 〈C〉ほら吹き
bran	 ふすま,ぬか 
brat	 《軽べつして》小僧,がき 
bray	 (ロバなどの)耳ざわりでしわがれた鳴き声 / (らっぱなどの)鳴り響く音 / 〈ロバなどが〉鳴く / 〈らっぱなどが〉鳴り響く
bred	 breedの過去・過去分詞 
brew	 醸造する / 《進行形で用いて》〈物事が〉熟してくる,起ころうとする / 〈ビールなど〉‘を'醸造する;〈混合酒〉‘を'造る;〈茶などの飲み物〉‘を'入れる;混合する / 〈悪事など〉‘を'たくらむ,計画する / 醸造酒,(特に)ビール;混合液 
brig	 ブリッグ(2本マストの帆船) / 《米おもに海軍俗》(特に艦内の)営倉
brim	 (茶わん・コップなどの)『縁』,へり(rim) / (帽子の)『つば』 / (…で)縁まで満たされる,あふれそうになる《[+『over』]『with』+『名』》 
brio	 活気,元気 
brow	 《複数形》『まゆ』,『まゆ毛』 / 『額』(forehead) / がけ(山)の端,斜面の上端 
brut	 (ぶどう酒が)甘味のない,辛口の 
buck	 (カモシカ・ウサギなどの)雄 
bugs	 競気の,気が競った 
buhl	 ブール細工家具(表面に金属・貝・べっ甲などをはめ込んだテーブル・食器だななど) 
bulk	 『かさばっていること』 / 《the bulk》(…の)大部分,大半《+『of』+『名』》 / ばら荷;(船の)積み荷 / かさばる,大きく見える
bump	 衝突;ごつんと当たること / ゴツン,ドスン[という音] / 打ちこぶ / ばたんと,どしんと / …‘に'突き当たる,ぶち当たる;(…に)…'を'突き当てる《+『名』+『on(『against』)+『名』》 / (…に)突き当たる《+『into』(『against』)+『名』》 / 《副詞[句]を伴って》〈車が〉ガタガタ揺れて通る 
bung	 (たるの)せん / =bunghole
bunk	 (また『bunk bed』)(船・列車などの)二段式寝台 / 《話》寝場所 / 寝台(寝だな)に寝る《+『down』》 
bunt	 (野球で)〈ボール〉'を'バントする / 〈ヤギ・小牛が〉…'を'角(頭)で突く / バントする / 角(頭)で突く / バント[をすること] / 角(頭)で突くこと
buoy	 浮標,ブイ(時に灯・鐘などがついている) / =life buoy / …'を'浮かせておく / …‘に'ブイをつける
burg	 《話》静かな小都市(町) 
burl	 (木の幹にできる)こぶ 
burn	 〈火・家などが〉『燃える』,『焼ける』 / (火や熱によって)『焦げる』,日焼けする / 『光』(『熱』)『を出す』 / (…で)熱さを感じる,ほてる《+『with』+『名』》 / (愛憎などで)燃える,かっかとなる《+『with』+『名』》 / …'を'『燃やす』,『焼く』 / …'を'焦がす;…'を'日焼けさせる / …'を'熱く感じさせる,'を'ほてらせる / …'を'燃料にする / 『やけど』;焼け焦げ / 『日焼け』 / ロケットの噴射・（CDなどに）焼く、（音楽｛おんがく｝やデータなどを）（CDなどに）焼く
burp	 げっぷ / げっぷが出る / …‘に'げっぷをさせる 
bury	 〈死体〉'を'『埋葬する』,土葬する,水葬する / (見えないように)…'を'『おおい隠す』 / …'を'深く突っ込む / (…に)〈人〉'を'没頭させる《+『名』〈人〉+『in』+『名』》
bush	 〈C〉『低木』(たけが低く根元から多数の小枝が発生している木) / 〈U〉《the bush》未開墾地,森林地 / 茂る,密生する;〈毛髪などが〉やぶのようになる 
busk	 大道芸をする 
bust	 〈C〉半身像,胸像 / 〈U〉《遠回しに》(婦人の)胸部
busy	 『忙しい』,多忙な / (場所が)『にぎやかな』 / 《米》(電話が)使用中の(《英》engaged) / 〈自分〉'を'忙しくさせる
byre	 牛小屋,牛舎 
byte	 バイト(コンピューターの情報伝達の単位で,8ビット(bit)からなる) 
cadi	 (イスラム教国の)裁判官 
cafe	 〈C〉『喫茶店』(coffeehouse),小レストラン);《英》(酒類を出さない)『軽食堂』 / 〈C〉バー,キャバレー,ナイトクラブ
cage	 『鳥かご』;(動物の)『おり』 / 鳥かご(おり)のような物;エレベーターの箱 / 野球の打撃練習用の移動バックネット / 獄舎 / …'を'かご(おり)に入れる 
cake	 〈U〉〈C〉『ケーハ』,洋菓子 / 〈C〉平たい焼きパン(パンケーキなど) / 〈C〉一定の形の塊にした食物 / 〈C〉(…の)ケーキ状の塊《+『of』+『名』》 / 固まる,塊になる / (…で)…'を'固める《+『名』+『with』+『名』》,(…に)…'を'なすりつける《+『名』+『on』+『名』》
calf	 {C}『子牛』 / 〈C〉(象・鯨・アザラシ・鹿などの)幼獣 / 〈U〉=calfskin 
calk	 =caulk 
calm	 (海・湖などが)『穏やかな』,静かな;(天候などが)穏やかな / (心・態度などが)『平静な』,落ち着いた(composed) / ''を'『なだめる』,静かにさせる / 〈U〉〈C〉『静けさ』,平穏;無風,凪(なぎ) / 〈U〉平静,落ち着き,沈着 
came	 comeの過去形 
camp	 〈C〉(軍隊・登山隊・探検隊などの)『野営地』 / 〈C〉〈U〉野営のテント,仮設小屋 / 〈U〉野営,キャンプ[生活];軍隊生活 / 〈C〉夏季キャンプ場,サマーキャンプ / 《集合的に》野営する人たち,キャンプする人たち / 〈C〉(主義・信条などを同じくする)同志たち,同じ陣営;同じ立場 / 『野営する』,キャンプ生活を送る《+『out』》 
cane	 〈C〉(トウ・タケ・サトウキビなどの)『茎』 / 〈U〉(用材としての)『トウ』(いす・かごなどを作る) / 〈C〉ステッキ,トウヅエ / 〈C〉むち / 〈C〉サトウキビ / 〈人〉'を'むち打って罰する / 〈家具〉'を'トウで作る(修理する) 
cant	 偽善的な言葉づかい,うわべだけの言葉,から念仏 / (特殊な階級・職業仲間などの)仲間言葉,隠語
cape	 ケープ(婦人服の短いそでなし外とう) 
card	 『カード』(長方形の厚紙);招待状,名刺,入場券 / =post card / (カードゲームの)礼(playing card) / 《複数形で》《単数扱い》カードゲーム / 《話》おもしろい人;(…の特徴をもつ)人物,やつ / 《米話》(スポーツ試合などの)好い組み合わせ;好番組
care	 〈U〉『心配』,気がかり,悩み / 〈C〉《しばしば複数形で》心配事,苦労の種 / 〈U〉『細心の注意』,十二分の用心 / 〈U〉(…の)『世話』,監督,保護《+『for(of)+名』》 / 〈C〉関心事,気を配るべきこと / 『気にする』,心配する,関心がある / …『したいと思う』,欲する,好む 
carp	 コイ 
cart	 (1頭立ての)『二輪車』,荷馬車,荷車 / 手押し車 / …'を'積んで運ぶ / (苦労して)〈物〉'を'かかえて運ぶ / 《話》…'を'引きずっていく《+『名』+『off』,+『off』+『名』》 
case	 〈C〉(…の)『実例』,事例《+『of』+『名』》 / 《the case》『実情』,真相 / 〈C〉〈U〉『場合』,情況,事情,立場 / 〈C〉(…の)(決定すべき)問題,重大事《+『of』+『名』》 / 〈C〉『訴訟』[『事件』],裁判 / 〈C〉(正当な)論拠,弁護;(被告または原告の)主張,申し立て / 〈C〉病状,容態;(症状から見た)患者 / 〈C〉〈U〉格(名詞・代名詞の語形変化)
cash	 『現金』,正金,銀行券,硬貨 / 〈小切手・為替など〉'を'『現金に換える』,現金化する
cask	 たる,おけ / たる1杯(の…)《+『of』+『名』》
cast	 …'を'『投げる』,ほうる / …'を'『投げ捨てる』,ほうり出す《+『off』+『名』,+『名』+『off』》 / (…に)〈影・光〉'を'『投げ掛ける』;〈疑に・魔法など〉'を'かける《+『名』+『on』 (『upon』)+『名』》 / 〈目・視線など〉'を'『向ける』,投げ掛ける / 〈票〉'を'『投じる』 / (…に)〈名誉・祝福〉'を'与える,〈非難など〉'を'浴びせる《+『名』+『on』(『upon』)+『名』》 / (人に)〈役〉'を'つける《+『名』〈役〉+『to』+『名』》;(ある役に)〈人〉'を'当てる《+『名』+『for』+『名』〈役〉》 / (鋳型に流し込んで)…'を'鋳造する / 物を投げる,(特に)釣り糸を投げる / 鋳造される / 〈C〉『投げること』,(光・影・視線などを)投げかけること / 〈C〉(物を)投げられる距離,射程 / 〈C〉(劇・映鹿を)『配役』 / 〈C〉(骨折した手足を固定する)ギプス / 〈C〉(…の)鋳型,鋳造[物]《+『of』+『名』》 / 〈C〉〈U〉(人・物の特懲的な)外形,外観;(…の)型,傾向;性質《+『of』+『名』》 / 〈U〉(…の)色あい,色調《+『of』+『名』》 / 《a cast》(材木などの)ゆがみ,そり;《まれ》(軽度の)斜視
cave	 『ほら穴』,(特に)横穴 / 〈地盤などが〉陥没する / 〈帽子など〉'を'へこます 
cavy	 テンジクネズミ(南米産) 
cent	 〈C〉『セント』(1ドルの1/100;米国・カナダの貨幣単位;《略》￠) / 〈C〉1セント銅貨 / 〈U〉(単位としての)100 
cert	 碓実[なこと] 
chap	 『やつ』(fellow) 
char	 …'を'焦がす / (焼いて)…'を'炭にする / こげる 
chat	 〈C〉〈U〉《話》(…との)『雑談』,談笑《+『with』+『名』》 / 〈C〉ツグミ類の鳥 / (…について)『談笑する』《+『away』+『about』+『名』》 
chef	 コック長,料理長 / コック,料理人
chew	 〈食物〉'を'『かむ』,かみくだく / …'を'かんで作る / かむ,かみこなす / かむこと;〈C〉かみ,一口
chin	 『あご』(下あごの先端) / (鉄棒で)懸垂をする
chip	 『木の切れ端』,削りくず;(石・陶器などの)『破片』,かけら / 欠けあと,ひび / 《複数形で》《英》=French fry / (食物の)薄切り / 干からびたもの;無味乾燥なもの / (ポーカーなどのゲームにお金の代りに使われる)チップ,点棒 / …'を'『欠く』,削る,そぐ《+『off』+『名,』+『名』+『off』》;(…から)…'を'欠く,そぐ《+『名』+『off』(『from』)+『名』》 / 欠ける,割れる《+『off』》;(…を)欠く,削る《+『at』+『名』》
chit	 (飲食店の)請求伝票 / 短い手紙;メモ
chop	 (なた・おのなどで)…'を'『たたき切る』,ぶった切る / …'を'たたき切って(切り開いて)作る / …'を'切り刻む《+『up』+『名,』+『名』+『up』》 / …'を'切って短くする / (テニス・クリケットで)〈ボール〉'を'切る / (…を)たたき切る,(…に)打ってかかる《+『at』+『名』》 / (テニス・クリケットで)ボールを切る / 『たたき切ること』,ぶった切り / 切り取った物;(骨つきの)厚切りの肉 / 小さく立ち騒ぐ波,逆波 / チョップ(テニス・クリケットで切りつけるように打つこと) 
chow	 チャウチャウ(中国原産の中型犬) 
chub	 チャブ(コイ科の淡水魚) 
chug	 シュッシュッと音をたてる(音をたてて動く)《+『along』(『away』)》 / (機関車・エンジンなどの)シュッシュッという音
chum	 《話》(特に男性の)親友,仲よし / (魚を集める)まき餌(え) / 《英古》(…と)部屋を分けあう《+『together with』+『名』》 / まき餌をまく
ciao	 やあ(Hi.) / じゃまた(So long.)
cine	 =cinematography 
cion	 =scion 
cite	 (作家・作品から)〈文章・句〉'を'『引用する』(quote)《+『名』+『from』+『名』》 / …'を'召喚する,呼び出す(summon) / (証拠・確認などのために)…'を'引き合いに出す / …‘に'感謝状を出す,'を'表彰する
city	 〈C〉(特に行政権を持っている)『都市』,都会,規模の大きい町 / 〈C〉《米》市(州の公認を得た市議会を持つ行政区で一般にtown, villageよりも大きい) / 《the cit・y》《集合的に》都市の[全]市民,全市 / 《the Cit・y》シティ(Londonの旧市街で商業・金融の中心地域)
clad	 clotheの（古語・文語における）過分・過去分詞 
clam	 ハマグリ / ハマグリを取る
clan	 (特にスコットランド高地人の)氏族 / 《話》一家,一族,一門 / (共通の利害を持つ)一味,一党,閥 
clap	 (短く鋭い)ピシャリ(パチン,バタン,ガタン)という音 / 《単数形で》平手打ち / 〈手〉'を'『パチン』(『パチパチ』)『とたたく』 / …'を'ピシャリ(パチン)とたたく(打ちつける) / (激励・あいさつとして)〈人〉'を'ポンとたたく / (ある方向・状態に)…'を'急に動かす,さっと送る / (…に)手をたたく《+『for』+『名』》 / ピシャン(パチン,バタン)と音を立てる
claw	 (鳥・動物の足の)『かぎづめ』;かぎづめのある足 / (エビ・カニなどの)はさみ / かぎづめの形をした物(くぎ抜きなど) / …'を'かぎづめでひっかく(引き裂く) / …'を'かぎづめでひっかいて作る 
clay	 『粘土』;泥土 / (聖書で,人間の肉体が造られているとされる)土
clef	 (楽譜の五線上の最初に付ける)音部記号 
clew	 (また『clue』)(森や迷路から抜け出すためたぐる)糸玉 / (難問解決の)糸口 / (また『clue』)帆耳(帆の最下端) 
clip	 『紙ばさみ』,クリップ;留める物 / (機関銃の) 挿弾子｛そうだんし｝、弾倉｛だんそう｝　…'を'『はさむ』,はさんで留める
clod	 (特に)土の塊,土くれ / 《話》ぼんくら
clog	 (…の)じゃま物,障害物《+『to』+『名』》 / 《複数形で》木(コルク)底の靴(サンダル) / …‘の'動きを妨げる / 〈管・道路など〉'を'ふさぐ,詰まらせる / 〈菅などが〉詰まる;〈油・泥などが〉固まって詰まる 
clot	 ゼリー状の固まり / 〈血液・ミルクなどが〉凝固する / …'を'凝固させる 
cloy	 〈ごちそう・ぜいたくなどが〉〈人・食欲など〉'を'あきあきさせる,うんざりさせる / 〈ごちそう・ぜいたくなどが〉あきがくる
club	 『こん棒』 / (ゴルフなどの)『クラブ』,打球棒 / (社交・スポーツなどの)『クラブ』,同好会;クラブ室,クラブ会館 / (カードで)クラブのマーク;クラブの札;《複数形で》《単数・複数扱い》クラブの組 / ナイトクラブ / …'を'こん棒でなぐる
clue	 (問題・なぞなどを解く)『手がかり』,(研究などの)『糸口』,端緒;(話などの)筋道《+『to』+『名』》 / =ciew1 / =clew3 / 《『clue in』(『up』)+『名,clue』+『名』+『in』(『up』)》(…について)…‘に'手掛かり(情報)を与える《+『about』(『on』)+『名』》
coal	 〈U〉(物質としての)『石炭』;〈C〉(1個の)『石炭』;《複数形で》(燃料用に砕いた)石炭の小塊 / 〈C〉燃えている燃料;燃えさし / 〈船・機関車など〉‘に'石炭を供給する(積み込む) / 〈船などが〉石炭を補給する
coat	 『コート』,オーバー,外とう / (男子背広・婦人スーツの)『上着』;(婦人・子供の)長上着 / (動物の)毛,毛皮;(植物の)外被,皮 / 表面をおおうもの;(ペンキ・ニスなどの)塗り;(金属などの)めっき / 〈人〉‘に'上着を着せる / 〈ほこりなどが〉〈症など〉'を'『おおう』;(ペンキなどで)〈壁など〉'を'塗る《+『名』+『with』+『名』》
coax	 (やさしい言葉・態度などで)〈人〉'を'『うまく説き伏せる』 / (人から)''を'うまく手に入れる《+『名』+『from』(『out of』)+『名』》
coda	 コーダ(楽章・楽曲の終曲部) 
code	 『法典』 / (社会・階級・団体などを支配する)『規約』,おきて,慣例 / 『信号法』;暗号 / 〈通信など〉'を'暗号(信号)にする
coif	 頭布(ずきん)(騎士がかぶとの下に修道女がベールの下につける) / =coiffure
coil	 (綱・針金などの)『輪』,うず巻き《+『of』+『名』》 / (…の)『一巻き』,1回の巻き《+『of』+『名』》 / (電気の)コイル;コイルを使用した装置 / (…の回りに)〈ロープ・針金など〉'を'『ぐるぐる巻く』《+『名』+『around』(『round』)+『名』》 / (…に)『巻きつく』,輪になる,取り往く,〈蛇などが〉とぐろを巻く《+『around』(『round』)+『 名』》 
coin	 (1枚の)『硬貨』(金貨・銀貨・銅貨・ニッケル貨など);〈U〉《集合的に》貨幣,硬貨 / 〈貨幣〉'を'鋳造する / 〈金属〉'を'(貨幣に)鋳造する《+『名』+『into』+『名』》 / 〈新語など〉'を'作り出す;〈理由など〉'を'でっちあげる
coir	 ココヤシの実の外側の毛で作ったロープ・マット用のじょうぶな繊維 
coke	 (燃料の)コークス / 〈石炭〉'を'コークスにする
cola	 〈C〉コーラの木(熱帯産の木) / 〈U〉コーラの木の実からつくった炭酸飲料(Coca-Cola, Pepsi Colaなど)
cold	 『寒い』,冷たい;冷えた,冷やした / (性格・態度などが)『冷たい』,冷淡な,熱意のない;無情な,冷酷な / (物事が)人をがっかりさせる,つまらない / (色調が)冷たい,寒色の / (獲物のにおい臭が)かすかな,弱い / 《話》(打撃などで)意識を失った,失神した / 完全に,全く / 〈U〉《しばしばthe~》『寒さ』,寒け,冷たさ / 〈C〉,時に〈U〉『かぜ』,感冒 
colt	 (雄の)『子馬』若ごま(普通4‐5歳まで) / 《話》青二才
coma	 こん睡状態 
comb	 『くし』;くし状の物 / くしでとかすこと,くし入れ / (綿・羊毛などをすく)すき機 / (鶏の)とさか / 波がしら / ハチの巣(honeycomb) / 〈髪〉'を'『くしですく』,とく;〈羊毛など〉'を'すく / (…を捜して)…'を'しらみつぶしに捜索する《+『名』+『for』+『名』》
come	 〈相手が〉(話し手の方へ)『来る』,やって来る;〈話し手が〉(相手の方へ)『行く』,伺う《+『to』(『into』)+『名』》 / (ある場所に)『着く』,到着する《+『to』+『名』》 / 〈時が〉『到来する』;〈順序が〉くる / (…に)『届く』,達する《+『to』+『名』》 / 〈事が〉(…に)『起こる』,生じる,降りかかる《+『to』+『名』》,(…から)起こる《+『from』(『of』)+『名』》 / 〈物が〉現れる,できる;〈子が〉生まれる / 〈考えなどが〉(人の)心に浮かぶ《+『to』+『名』》 / 〈人が〉(…の)『出身である』,生まれである《+『from』(『of』)+『名』》 / 〈商品などが〉利用できる,手に入る / (ある状態・結果に)『なる』,至る / 《命令形で促したり警告などを表して》さあ,これこれ / 《仮定法現在で,年月・時期などを表す語[句]の前で》…が来ると / 《仮定法現在》〈障害・難関など〉が来ても / 《『come the』+『名』の形で》(…の)ふるまいをする,(…)ぶる
coms	 《話》=combination4 
cone	 円すい,円すい形 / 円すい形のもの / 球果(松かさなど)・暴風警報球. 
conk	 〈人〉‘の'頭をゴツンとやる / 鼻
cope	 対抗する;(難局に)対処する,打ち勝つ《+『with』+『名』》 
copy	 〈C〉『写す』,複写,(絵などの)模写,複製;謄本,抄本 / 〈C〉(同一書籍・雑誌・新聞などの)『部,冊』 / 〈U〉(印刷の)原稿,草稿 / 〈U〉ニュースねた,原稿材料 / …'を'『写す,複写する』,模写する / …'を'まねた / (…から)…'を'こっそり写す,盗作する《+『名』+『from』(『off』)+『名』》 / (…から…へ)『複写する』《+『from』(out of』)+『名』+『into』+『名』》 / (…を)こっそり写し取る《+『from』(『off』)+『名』》 
cord	 〈U〉〈C〉『綱,ひも』(stringより太くropeより細い) / 〈U〉〈C〉束縛,きずな / 〈C〉〈U〉(電気の)『コード』,線 / (またchord)〈C〉(動物体の)索状組織,腱(けん) / 〈C〉うね織り,(特に)コールテン;(うね織りの)うね;《複数形で》コールテンのズボン / 〈C〉コード(材木の容積の単位で約6.25m) / …'を'綱(ひも)で縛る 
core	 〈C〉(果物の)『しん』 / 〈U〉(物事の)核心 / 〈C〉(電気の)磁心,磁極鉄心 / …‘の'しんを抜く
cork	 〈U〉『コルク』[質] / 〈C〉コルクの栓,コルク製品 / …‘に'コルクで栓をする / コルク製の
corm	 球茎 
corn	 〈U〉(米,カナダ,オーストラリアで)『とうもろこし』;〈C〉とうもろこしの実(おもに《英》maize, Indian corn) / 〈U〉《英》《集合的に》『穀草』(wheat, oatsなど);『穀物』,穀類;穀粒 / 〈C〉《話》古くさい(お涙ちょうだい的な)もの(こと) / 〈牛肉など〉'を'塩づけにする
cosh	 (武器として用いる金属・石などを詰めた)こん棒 
cost	 〈品物が〉〈ある金額〉‘が'『かかる』,'を'要する / 〈物事が〉…'を'『犠牲にさせる』,失わせる / 〈仕事など〉‘の'手間(原価)を計算する / 『代価』,値段;《しばしば複数形で》経費,費用 / 《the cost》『犠牲』,損失 / 《複数形で》訴訟費用
cosy	 =cozy / =cozy
cote	 (羊など小さな動物や鳥を入れる)小屋 
coup	 不意に一激 / 大当たり,大成功 / =coup d'etat 
cove	 小さな入江,小湾 / (山や森の)隠れたくぼみ,奥まった所
cowl	 (修道僧の着る)ずきん付き外衣;(僧衣についた)ずきん,僧帽 / (換気筒の)通風帽 / =cowling 
crab	 〈C〉カニ;〈U〉カニの肉・〈C〉巻き揚げ機・〈C〉《話》気むずかし屋・カニをとる・《話》ぶつぶつ不平を言う・…'を'ふくれさせる・= crab louse（毛ジラミ）
crag	 ごつごつした岩,険しい岩山 
cram	 (…に)…'を'ぎっしり詰める《+『名』+『in』(『into』)+『名』》;(…で)〈物〉'を'いっぱいにする《+『名』+『with』+『名』》 / 〈人〉‘に'(…の)詰め込み勉強をさせる《+『名』+『with』+『名』》;〈学科〉'を'詰め込む / (…の)詰め込み勉強をする《+『for』+『名』》 
crap	 〈U〉うんこ,くそ・糞 / 《a~》うんこをすること / 〈U〉ほら,たわごと / 〈U〉がらくた,ごみ / うんこをする / ふん,ばかばかしい
craw	 (鳥・昆虫の)え袋;(動物の)胃袋 
crew	 (船・飛行機の)『乗組員』[全員];(高級船員を除いた)船員,(高級乗務員を除いた)搭乗(とうじょう)員 / (共同の仕事をする)従業員[全員],作業団[全員] / (ボートレースの)クルー / 《話》仲間,連中
crib	 《おもに米》わく付きの)小児用寝台《英》cot) / (横木のついた)かいばおけ / 《米》(穀物・塩などの)貯蔵箱,貯蔵小屋 / (鉄や木の)わく / 《話》(他人の言葉・アイデアの)盗用,無断借用《+『from』+『名』》 / 《話》(学生の)とらの巻(pony) / 《英》=creche2 / (狭いところに)'を'押し込む / 《話》…'を'盗用する / カンニングする
crop	 〈C〉《しばしば服数形で》『作物』,『収穫物』 / 〈C〉(一地域で一期にとれる農作物の)『収穫』[『高』],生産[高],作柄 / 〈U〉作付け,植う付け,耕作 / 〈C〉《通例単数形で》(同時に,または続々と出てくる人・物の)群れ《+『of』+『名』》 / 〈C〉《通例単数形で》(髪の)刈込み,いがぐり頭 / 〈C〉(鳥の)え袋,そのう / 〈C〉(動物の耳を切って目じるしにする)耳じるし / 〈C〉乗馬むち;むちの柄 / 〈草・毛などの先〉'を'刈り込む,かみ切る / (…を)…‘に'植え付ける《+『名』+『with』+『名』》 / 作物ができる;作物を植える 
crow	 『カラス』 / =crowbar
crux	 最も重要な点 / 難問,なぞ
cube	 〈C〉『立方体』;立方体の物(さいころ,敷石,木れんがなど) / 〈U〉立方,3乗 / 〈数〉'を'3乗する / ''を'立方体に切る
cubs	 ボーイスカウト幼年団 
cult	 (宗教的)儀式;信仰,祭礼 / (人・物に対する)崇拝,礼賛,…熱《+『of』+『名』》
cunt	 女性の性器 / 《軽べつに用いて》ばか,くそったれ
curb	 (馬の)くつわ鎖,止めぐつわ / 拘束,抑制 / 《米》(歩道を車道と区分するため縁にそって並べた)縁石(《英》kerb) / (止めぐつわで)〈馬〉'を'制御する / 〈感情・欲望など〉'を'抑制する 
curd	 《しばしば複数形で;単数扱い》凝乳,カード(チーズの原料) / 凝乳状の食品
cure	 〈病気・病人〉'を'『治療する』,なおす / 〈悪癖・弊害など〉'を'『なおす』,取り除く / (塩づけ・燻製(くんせい)などにして)〈魚・肉など〉'を'保存する / 〈病気が〉なおる / (塩づけ・燻製などにして)〈魚・肉などが〉保存させる / 〈U〉〈C〉(病気の)『回復;治療』 / 〈C〉(…の)『治療薬』;『治療法』《+『for』+『名』》 
curl	 〈C〉『巻き毛』カール;《複数形で》巻き毛の髪 / 〈C〉うず巻き[状のもの],うねり / 〈C〉〈C〉カールすること,ねじれ / 〈頭髪〉'を'カールさせる / |'を'曲げる,ねじる / 〈頭髪が〉カールする / 〈煙が〉うず巻く 
curt	 (言動などが)そっけない,ぶっきらぼうな 
cusp	 (歯などの)とがった先 / (新月の)先端
cute	 (小供・物などが)『かわいい』,気のきいた 
cyan	 青緑色,シアン 
cyme	 集散花序(植物の花の咲き方の一つ) 
cyst	 胞嚢(ほうのう) 
czar	 帝政ロシアの皇帝 / 専制君主;独裁者
dabs	 指紋 
dace	 ウグイ,アカハラ(北米・欧州産の淡水魚) 
daft	 とんまな / 気違いじみた
dago	 《軽べつして》スペイン(ポルトガル,イタリア)系の人 
dais	 (大広間・宴会場などの)上段;(講堂の)演壇,教壇 
dale	 谷(valley) 
dame	 《古》貴婦人(lady),夫人(madam) / 《D-》《英》(1)(もと)knight(またはbaronet)の夫人 / (2)knightに相当する勲位に叙せられた婦人の呼称 / 年配の婦人 / 《米俗》女 
damn	 …'を'『けなす』,酷評する / 〈神が〉〈人〉'を'地獄に落とす,永遠に罰する / …'を'破滅させる,だめにする / …'を'のろう / 〈U〉〈C〉ののしり,けなし / 〈C〉《話》《否定文に用いて》《a~》少し / =damned / =damnation
damp	 〈U〉『湿気』,しめり(moisture) / 〈U〉もや,霧(mist) / 〈U〉(鉱山の)有毒ガス / 《a~》気持ちのめいらせるもの / 『湿っぽい』,湿気のある / …'を'湿らせる / …‘の'勢いを弱める,そぐ《+『down』+『名,』+『名』+『down』》 / 〈ピアノ・弦楽器の弦〉‘の'振動を弱める(押える)《+『down』+『名,』+『名』+『down』》
dank	 じめじめした,湿っぽい 
dare	 『あえて…る』 / 《『dare to』 do》『思いきって…する』,…する勇がある / 〈危険など〉‘に'『立ち向かう』 / 〈人〉‘に'『挑む』,挑戦する(challenge) / 挑戦[すること](challenge) 
dark	 『暗い』やみの / (毛髪・皮膚・目の)『浅黒い』,(色の)濃い / 陰うつな,陰気な(gloomy) / 腹黒い,悪意のある(evil) / 隠した,秘密の / (意味が)明らかでない,なぞめいた / 未発の;無知の / 〈U〉《the~》『やみ』,暗がり(darkness) / 《冠詞なしで》『夜』(night);『日暮れ』(nightfall) / 〈U〉暗い色,濃い陰
darn	 〈ほころび〉'を'縫い繕う,かがる / 縫い繕った所,かがり縫い
dart	 (武器の)『投げやり』,(投げ矢遊びの)投げ矢 / (昆虫の)針 / 《複数形で》投げ矢遊び / 《a~》急激な突進 / ダーツ(洋服を体に合わせるための縫いつまみ) / (…に)〈やり・矢,視線など〉'を'投げる,投げかける / (投げ矢のように)『突進する』,さっと動く 
dash	 《副詞[句]を伴っで》『突進する』 / (…に)『衝突する』,激しくぶつかる《+『against』(『into, onto』)+『名』》 / (…に)…'を'『打ちつける』,投げつける《+『名』+『against』(『into, to』)+『名』》;…‘に'打ちつける / 〈元気・希望など〉'を'くじく,〈人〉'を'落胆させる(depress) / (…に)〈木など〉'を'ぶっ掛ける,浴びせる《+『名』+『in』(『on, over』)+『名』》;(水などを)…‘に'ぶっかける《+『名』+『with』+『名』》 / 〈C〉《a~》(…への)『突進』,疾走(rush)《+『at』(『for』)+『名』》 / 《the~》短距離競走 / 《the~》(…に)打ちつける音《+『against』(『on』)+『名』》 / 〈C〉(元気・希望などを)くじくもの,(…の)障害《+『to』+『名』(do『ing』)》 / 〈C〉(混合・添加する)(…の)少量《+『of』+『名』》 / 〈U〉映気;(…する)気力《+『to』 do》 / 〈C〉ダッシュ(一の符号) / 〈C〉モールス信号の長音 
date	 〈C〉『日付』,年月日 / 〈U〉(歴史上の)『時代』,年代 / 〈C〉(…の)約束[の日]《+『for』+『名』》;《話》(異性との)デート《+『with』+『名』》 / 〈C〉《おもに米話》デートの相手 / 《複数形で》(ある人の)生没期間,生没年;(物事の)開始と終了の期日 / …‘に'『日付を入れる』,年月日を書く / …‘の'『年代』(『時代』)『を定める』,年代を算定する / …'を'古くさくする,時代遅れにする / 《おもに米話》〈異性〉‘と'デートする / 『日付がある』;(特定の時代に)『始まる』,(…に)起源をもつ《+『from』(『back to』)+『名』》 / 時代遅れになる / 《おもに米話》デートする
daub	 (塗料などで)…'を'塗りつぶす《+『名』+『with』+『名』》 / (…に)〈塗料など〉'を'塗り付ける《+『名』+『on』+『名』》 / へたくそに(雑に)塗る(描く) 
dawn	 〈U〉〈C〉『夜明け』,暁(daybreak) / 《the ~》(物事の)『始まり』,端緒《+『of』+『名』》 / 『夜が明ける』,明るくなる / 〈物事が〉はっきりして来る,現れ始める
days	 たいてい昼間は 
daze	 (打撃・衝撃などで)…'を'ぼう然とさせる / ぼうっとした状態
deaf	 『耳が遠い』,耳が不自由な / 《the deaf;名詞的に》耳が不自合な人々 / 《補語にのみ用いて》(…を)『聞こうとしない』(…に)むとんじゃくである《+『to』+『名』》 
deal	 …'を'『分配する』,分ける / 《『deal』+『名』+『名』=『deal』+『名』+『at』(『to』)+『名』》〈打撃・仕打ちなど〉'を'…‘に'『加える』 / 〈U〉取引き / 〈C〉(取引きなどの)妥協,協定 / 〈C〉カードゲームの札の配分 / 《D-》政策(policy) / 《a~》《話》取扱い,待遇 
dean	 (大学の)学部長 / (米国の大学の)学生部長;(英国の大学の)学生監 / (英国国教会で)司祭長;(ローマカトリック教会の)司教地方代理 / (団体の)長老
dear	 『親愛な,かわいい』(much loved) / (手紙の書き出しのあいさつの)『親愛なる』,尊敬する / 『大事な』,貴重な;(…にとって)大事な《+『to』+『名』》(precious) / 高い/,高価な / 『高価に』,高く / 『かわいい人』,大切な人,いい子 / 『おや,まあ』(驚き・同情・悲しみ・困惑などを表す) 
debt	 〈U〉〈C〉『借金』;負債 / 〈C〉『恩義』,義理(obligation)
deck	 『デッキ,甲板』 / デッキ状の部分(バス・電車の床,トラックの荷台,電気装置の配置台など) / 《おもに米》(カードの)1組(《英》pack) / 《話》地面 / (…で)…'を'飾る,装飾する《+『out』+『名』+『with』+『名』》 / (…で)…'を'美しくする,めかす《+『out』+『名』+『in』+『名』》
defs	 definitions 
deft	 器用な,巧みな,じょうずな 
defy	 《『defy』+『名』+『to』 do》(…してみよと)〈人〉に『挑む』,挑戦する / …'を'『無視する』,ものともしない / 〈物事が〉…'を'『拒む』,受け付けない 
dent	 くぼみ,へこみ / …‘を'くぼませる,へこませる / へこむ,くぼむ 
deny	 …‘を'『否定する』,否認する / 《『deny』+『名』+『名』=『deny』+『名』+『to』+『名』》〈人・自分〉‘に'…‘を'与えない(許さない)
derv	 ダーブ(ディーゼルエンジン用燃料油;商標名) 
desk	 『机』,勉強机,事務机 / 受付所,応接所 / (新聞社・役所などの)部局 
dewy	 露の降りた露にぬれた / 露に似た,露のように新鮮な
dhow	 ダウ船(アラビアの帆船) 
dial	 (時計の)『文字盤』;(各種計器類の)目盛り盤,指針盤 / (ラジオ・テレビの)『ダイヤル』 / (電話の)ダイヤル / 日時計(sundial) / 〈ラジオ・テレビ〉‘の'ダイヤルを回す;〈番組・波長〉‘に'ダイヤルを合わせる / 〈電話・番号〉‘の'ダイヤルを回す;〈人〉‘に'電話をかける / (電話の)ダイヤルを回す 
dice	 さい,さいころ / さいころ遊び,ばくち / …‘を'ばくちで失う / (…をかけて)〈人〉‘と'さいころを振る《+『名』+『for』+『名』(『wh-節』)》 / 〈野菜など〉‘を'さいの目に切る / ばくちをする
dick	 《米俗》デカ,刑事 / 《卑》陰茎
diet	 (日本・デンマーク・スウェーデンなどの)『議会』,国会 
dime	 ダイム(米国およびカナダの10セント銀貨) 
dine	 (一日のおもな食事として)正餐(晩餐)をとる 
ding	 〈鐘など〉‘を'ガンガン鳴らす / 〈鐘などが〉ガンガン鳴る / (鐘の)ガンガン鳴る音 
dink	 ドロップショット(ネット上すれすれに打つテニスの打法) 
dint	 (打ってできた)くぼみ,へこみ(dent) / (たたいて)…‘を'へこます(dent)
dire	 恐ろしい,ものすごい;不吉な / 差し迫った(urgent);極端な
dirk	 (昔スコットランドで用いた)短剣 
dirt	 『不潔な物』,汚物;泥,ほこり,ごみ / 土(soil) / 無価値なもの / わい談,春画,わいせつ本(pornography) / 《話》卑わいな言葉;(特に)卑わいな悪口 
disc	 =record / =disk
dish	 〈C〉(全員分の料理を盛る)『大皿』,盛り皿,深皿 / 《しばしばthe ~》《複数形で集合的に》(食事に用いる,おもに陶器製の)皿類,食器類(plates,bowls,saucers,cups,knives,forksなどの総称) / 〈C〉(皿に盛られた)『料理』,食品 / 〈C〉(…の)皿1杯の分量,一皿分《+『of』+『名』》 / 〈C〉《話》可愛い女の子 / 〈食物〉‘を'皿に盛る;〈人〉‘に'盛りつけて出す《+『名』+『up』,+『up』+『名』》
disk	 『円盤』;円盤の表面 / 植物,動物の平たく丸い組織・部分;椎間板(ついかんばん) / (数学で)円板(円によって囲まれた範囲) / レコード
diva	 (オペラなどの)プリマドンナ 
dive	 (…から水中などに)『頭から飛び込む』《+『from』(『off』)+『名』+『into』(『in』)+『名』》 / (…を取ろうと)『潜る』,潜水する《+『down for』+『名』》 / (…へ向かって)急降下する,急潜航する《+『down toward』+『名』》 / (…に)駆け込む,逃げ込む《+『into』+『名』》 / (…に)手を突っ込む《+『in』(『into』)+『名』》 / (仕事・問題などに)飛び込む《+『in』(『into』)+『名』》 / …‘を'急降下させる,急潜航させる / 『飛び込み』 / (飛行機の)急降下;(潜水艦・潜水夫などの)急潜航 / 《話》怪しげなナイトクラブ,いんちき酒場
dock	 『波止場』,埠頭(ふとう) / (入港中の船を入れておく)船だまり / (造船,修理用の)『ドック』,船渠(せんきょ) / 〈船〉‘を'ドックに入れる / 〈2個以上の宇宙船〉‘を'大気圏外で連結させる / 〈船が〉ドックにはいる / 〈宇宙船が〉大気圏外で連結する,ドッキングする 
doer	 (思索型の人に対して)実行家,行動家 
does	 doの三人称・単数・直説法現在形 
doge	 ドージェ(昔のベニス・ジェノバ共和国の総督) 
dole	 (金銭・食物の)施し物 / 《英話》失業手当 / 《dole out+名,dole+名+out》〈金銭・食物〉‘を'少しずつ分配する,けちけち与える 
dolt	 まぬけ,とんま 
dome	 (半球形の)『丸屋根』,丸天井,ドーム / 丸屋根状のもの / …‘に'ドームをつける,‘を'ドームでおおう 
done	 doの過去分詞 / 仕上がった,完成した / 「(食べ物が)焼けた」の意を表す 
dope	 〈U〉ドープ(機械の潤滑剤);ドープ塗料(航空機翼などに塗る) / 〈U〉《話》(人・馬の)興奮剤,麻酔薬,麻薬 / 〈U〉《俗》(特に確かな筋の)情報 / 〈C〉《俗》まぬけ,ばか者 / …‘に'ドープ塗料を塗る / 《話》〈人・馬〉‘に'興奮剤(麻薬)を飲ませる
dorm	 =dormitory 
dory	 (北米東海岸地方で用いられる)平底船(タラ漁用) / (また『John Dory』)マトウダイ(大きな食用魚)
dose	 (おもに飲み薬1回分の)『服用量』 / (痛いこと・いやなことの)1回分,一定量 / (人などが受ける放射線の)線量 / 性病 / (…を)…‘に'投薬する,服用させる《+『名』+『with』+『名』》 
dost	 doの二人称・単数・現在形 
dote	 もうろくする / (…を)溺愛(できあい)する《+『on』(『upon』)+『名』》
doth	 doの三人称・単数・現在形 
dour	 むっつりした,陰気な / 厳格な,厳しい(stern)
dove	 『ハト』(pigeonのうち比較的小さいもの;平和の象徴とされる) / 《おもに米》(平和的な態度をとる)ハト派の人(政治家)
down	 (高い所から)『下へ』,降りて,地面へ / (地理・地図上)南へ,下町へ;(風・流れなどが)『下(しも)手へ』;《英》(都会・大学から)地方へ,離れて / (価格・品質・温度などが)『下がって』,(数量・スピードなどが)少なく,減じて,(濃度が)薄く / (健康・風の勢いなどが)『衰えて』,気分が沈んで / (時代などが)下がって,…に至るまで / (身分・地位が)下がって / (紙面に)書き留めて,記録して / (頭金を)現金で,即金で / 最後まで,徹底的に / しっかりと,動けないように / (高い所から)…『を下がって』;…『に沿って』;…の向こうに / …の下流に / …以来 / 《名詞の前にのみ用いて》『下りの』,下への / 《名詞の前にのみ用いて》(列車・バスなどが)下りの / 《補語にのみ用いて》下に,下がって / 《補語にのみ用いて》弱まった,おさまった;落胆した,元気のない / 《補語にのみ用いて》(勝負で)負けて,すって / 《補語にのみ用いて》《おもに米話》(野球で)アウト / …‘を'打倒する,負かす,撃ち落とす / …‘を'飲み干す,飲み込む / 下り,下降 / 《複数形で》不運,逆境 
doze	 うたた寝をする,居眠りをする《+『off』》 / 〈時〉‘を'うとうとと過ごす《+『away』+『名』》 / うたた寝,居眠り 
dozy	 眠そうな;眠気を催させる / 《英話》(人が)愚かな
drab	 単調な,退屈な,おもしろくない / くすんだ茶色の / くすんだ茶色,灰色がかったかっ色,土(つち)色 
drag	 〈重い物〉‘を'『引きずる』(haul) / 《副詞[句]を判って》…‘を'引っ張ってゆく / (網などで)(…を捜して)〈川・湖など〉‘の'底をさらう《+『名』+『for』+『名』》 / …‘を'だらだらと引き延ばす《+『out』+『名,』+『out』》 / (地面に)『引きずる』《+『along』》 / 〈物が〉重そうに動く;のろのろ進む / だらだらと長引く《+『on』(『out』)》 / 〈C〉〈U〉引っ張ること,引きずること / 〈C〉物事を遅らせる原因になる人(物);(…の)足手まとい,じゃま物《+『on』(『upon』)+『名』》 / 〈C〉水の底を探る物(探り錨,引き網など) / 〈C〉引きずられる物(重いまぐわ,犬ぞりなど) / 〈U〉《a~》(航空機の)抗力 / 《a~》《俗》退屈な人(物,事) 
dram	 ドラム(重量の単位で常衡は1.772グラム,薬局衡では3.9グラム) / (ウイスキーなどの)微量,一口《+『of』+『名』》 / (一般に)わずか(の…)《+『of』+『名』》 
drat	 =damn 
draw	 …‘を'『引く』,引っぱる / 《副詞[句]を伴って》…‘を'『引いて』(ある状態に)『する』 / (…から)…‘を'『引き抜く』,取り出す《+『名』+『from』(『out of』)+『名』》 / (…から)〈液体など〉‘を'『くみ出す』,くみ上げる《+『名』+『from』+『名』》 / (…から)…‘を'得る,引き出す《+『名』+『from』+『名』》 / 〈事〉‘を'招く,もたらす / 〈人〉‘を'引きつける,引き寄せる / 〈絵・図〉‘を'『線で描く』,〈線〉‘を'引く / …‘を'描写する,述べる / 〈文書〉‘を'書く,作成する;〈小切手〉‘を'振り出す / 〈息〉‘を'吸い込む;〈ため息〉‘を'つく / …‘を'引き伸ばす,いっぱいに張る / 〈くじなど〉‘を'引く,引き当てる / 〈勝負など〉‘を'引き分ける / 喫水が…‘だけ'ある / 《副詞[句]を伴って》『動く』,『近づく』,行く / (…に向けて)剣(ピストル)を抜く《+『on』+『名』》 / 《副詞[句]を伴って》人を引き付ける / 《副詞[句]を伴って》『線で書く』 / くじを引く / 《副詞[句]を伴って》〈水が〉はける,〈パイプ・煙突などが〉通る / (勝負などが)引き分けになる / 〈茶などが〉出る / 〈船が〉喫水する / 引くこと,抜くこと,(たばこなどの)一吸い,一服 / (人を)引きつけるもの,呼び物,人気者 / くじ引き,抽せん(lot) / 引き分け,無勝負
dray	 (4輪で台の低い)荷[馬]車 / …‘を'荷[馬]車で運ぶ
drew	 drawの過去形 
drip	 〈液体が〉『したたる』,しずくを垂らす,ぽたぽた落ちる《+『down』》;(…から)したたる《+『from』+『名』》 / 〈容器などが〉しずくを垂らす / (…で)びしょぬれになる,あふれる《+『with』+『名』》 / 〈液体〉‘を'したたらせる / 〈C〉『したたり』,しずく / 〈U〉したたること;しずくの落ちる音
drop	 〈しずくが〉『したたる』,垂れる《+『down』》 / 〈物が〉『落ちる』,落下する《+『down』》 / 〈人が〉『ばったり倒れる』,崩れ落ちる / 『下落する』,減少する《+『off』(『away』)》 / 終わる,やめになる / 《副詞[句]を伴って》引き離される,落後する / (…から)手を引く,やめる《+『from』(『out of』)+『名』》 / (…に)ちょっと立ち寄る,(…を)ひょっこり訪ねる《+『in』(『by,over,round』)『at』(『on』)+『名』》 / …‘を'『したたらせる』,垂らす / (…へ)…‘を'『落とす』,落下させる《+『名』+『into』(『on』)+『名』》 / …‘を'降ろす,下げる / …‘を'減少させる / …‘を'漏らす,ふと口にする / 〈人〉に〈短い手紙・伝言〉‘を'送る / 《話》…‘を'なぐり倒す,撃ち落とす / 《話》《副詞[句]を伴って》〈人〉‘を'乗り物から降ろす / (…から)〈ある音・文字〉‘を'落とす,抜かす,省く《+『名』+『from』+『名』》 / 〈人〉‘と'関係を絶つ;〈問題など〉‘を'打ち切る / …‘を'やめさせる;(…から)…‘を'追い出す《+『名from』+『名』》 / (ばくちなどで)〈金〉‘を'なくす / 〈C〉(…の)『しずく』,したたり《+『of』+『名』》 / 〈C〉(液体・事物の)少量,微量《+『of』+『名』》 / 〈C〉あめ玉,ドロップ / 《a ~》落下,降下(fall);落下距離 / 《a ~》(…の)下落,減少《+『in』+『名』》 / 《複数形で》点滴薬 / 《話》《a ~》少量の酒 / 〈C〉《おもに米》(郵便箱などの)落とし口,差し入れ口
drub	 (棒などで)…‘を'強く打つ / (試合などで)〈相手〉‘を'決定的に負かす
drug	 『薬』,薬品,薬剤 / 『麻薬』,麻酔剤 / 〈人〉‘に'薬(特に麻酔剤)を与える / 〈飲食物〉‘に'(麻酔薬・毒薬などの)薬を混ぜる
drum	 『太鼓』,ドラム / 太鼓の音;太鼓のような音 / (形が)太鼓状のもの;(機械の)ドラム;ドラムかんなど / =tympanic membrane / 太鼓を打つ(鳴らす) / (…でテーブル・床などを)ドンドン打つ,トントンたたく,踏みならす《+『on』+『名』+『with』+『名』》 / …‘を'ドンドン(トントン)打つ(鳴らす) / 《話》(人の頭などに)〈考えなど〉‘を'たたき込む,教え込む《+『名』+『into』+『名』》 / (…から)〈人〉‘を'追放(除名)する《+『名』+『out of』+『名』》 
dual	 二つの部分(2個)から成る / 二重の性質がある
duck	 〈C〉『アヒル』,『カモ』 / 〈C〉雌のカモ,雌のアヒル / 〈U〉(食用にする)カモ,アヒルの肉 / 〈C〉《おもに英話》かわいい人
duct	 送水管;(建物・船などの)通気管;(地下ケーブルなどの)ダクト / (体液を運ぶ)導管,(植物が水・空気を運ぶ)導管
duel	 決闘 / (2者・2集団などの間の)闘争,抗争 / 決闘する / …‘と'決闘する
duet	 二重唱,二重奏,二重唱(奏)曲 
duke	 (イギリスの)公爵 / (欧州大陸の小国または公国の)君主
duly	 正しく,当然に,順当に 
dumb	 『物の言えない』,口をきくことができない / 口をつぐんでいる,黙っている(silent) / 《名詞的にthe~》口のきけない人々 / 《話》頭の悪い,ばかな
dump	 〈重い荷物など〉‘を'『どさっと落とす』(降ろす);〈ごみなど〉‘を'どさっと捨てる / (特に外国市場で)〈商品〉‘を'投げ売りする,ダンピングする / ごみ捨て場 / (捨てられた)ごみの山 / (弾薬・軍需品などの)臨時集積場 
dune	 (海浜・砂漠の)砂丘 
dung	 (家畜の)ふん,こやし 
dunk	 (コーヒー・ミルクなどに)〈パン・ドーナツなど〉‘を'浸して食べる《+『名』+『in』(『into』)+『名』》 / …‘に'浸す,漬ける
dupe	 (他の人に)だまされやすい人《+『of』+『名』》 / 〈人〉‘を'だます;〈人〉‘を'かついで…させる《+『名』〈人〉+『into』 do『ing』》
dusk	 (特に夕暮れの)たそがれ / (ある所の)薄暗がり
dust	 〈U〉『ちり』,ほこり / 《a ~》土煙,砂ぼこり / 〈U〉粉末,粉 / 《the ~》《文》遺骨,なきがら / 〈U〉(死後の)土 / 〈U〉屈辱,恥 / 〈U〉つまらぬもの / …‘の'『ちりを払う』,ごみをふき取る《+『名』+『off』(『down』),+『off』(『down』)+『名』》;(…から)…‘を'払う《+『名』+『from』+『名』》 / (粉などを)…‘に'振り掛ける《+『名』+『with』+『名』》 / (家具などの)ほこりを払う
duty	 〈C〉〈U〉(道徳・法律上の)『義務』,本分,義理 / 〈C〉《しばしば複数形で》(地位・職業などからくる)『任務』,職務,仕事 / 〈U〉《古》尊敬,敬意 / 〈C〉《しばしば複数形で》『税』(tax),関税
dyer	 染め物屋(職人) 
dyke	 =dike 
dyne	 ダイン(力の絶対単位;1グラムの物体に1秒につき1cm/秒の加速度を生じる力) 
each	 『おのおのの』,『めいめいの』,各… / 『各自』,おのおの,めいめい / めいめい[に],それぞれ 
earl	 (英国の)伯爵 
earn	 (正業で働いて)〈金など〉‘を'『かせぐ』 / (努力して)〈信用・名声など〉‘を'得る / (貯金などが)〈利益〉‘を'生じる,生む 
east	 《the~》『東』;(…の)東方,(…の)東部《+『of』+『名』》 / 《the East》『東洋』(the Orient) / 《the East》《米》東部地方 / 『東の』,東方の,東部の;東からの / 『東に』,東方へ 
easy	 (事が)『容易な』,骨の折れない / 『心配のない』,気楽な / 寛大な,甘い / (速度などが)ゆるやかな;(衣服などが)ゆったりした / 楽々と;のんきに 
ebon	 =ebony 
echo	 〈C〉〈U〉『反響』[音];『こだま』,山びこ / 〈C〉〈U〉(意見・心情などに対する)共鳴,反応 / 〈C〉〈U〉(他人の行為・意見などの)繰り返し,まね《+『of』+『名』》;(…からの)影響《+『from』+『名』》;〈C〉まねをする人 / 〈場所が〉…‘を'『反響させる』 / 〈人の言葉・意見〉‘を'『そのまま繰り返す』,そっくりまねる / (…で)〈場所・音・声が〉『反響する』《+『with』+『名』(do『ing』)》
ecru	 =beige 
edgy	 (…で)(人が)いらいらした《+『with』(『about』)+『名』》 / しきりに(…)したがって《+『to』 do》
edit	 …‘を'編集する / 〈原稿など〉‘を'校訂する,〈本など〉‘を'監修する / (…から)〈文章など〉‘を'削除する《+『名』+『out of』+『名』》 
egad	 やあ,いやはや! 
egis	 =aegis 
elan	 熱意;気力 
elhi	 小中高校の(elementary and high schoolの略) 
emir	 (アラビアの)首長,王族 / エミール(マホメットの子孫の尊称)
emit	 〈水・熱・光・音・声など〉‘を'『出す』,『発する』 
envy	 〈U〉(…に対する)『ねたみ』,羨望(せんぼう)《+『of』(『at』)+『名』》 / 〈C〉(…の)『羨望の的』,うらやましい物(人,事)《+『of』+『名』》 / …‘を'『うらやむ』,ねたむ 
epic	 『叙事詩』 / 叙事詩の,叙事詩に似た / 叙事詩に歌われているような,壮大な 
ergo	 それ故に,したがって 
erst	 昔は,以前は 
espy	 〈遠くのもの・隠れたもの・意外なもの〉‘を'見付ける 
etch	 〈絵など〉‘を'エッチングで描く(彫る) / エッチングで描く
evil	 (思想・行動などが)『邪悪な』,罪深い / 害を与える,有害な / 『不吉な』;不運な / 〈U〉『悪』,罪悪 / 〈C〉『害悪』,悪弊 / 不幸,不運 / 悪く 
exam	 試験 
exit	 『出口』 / 退出,退去;(舞台からの俳優の)退場
eyot	 (川の中の)小島 
face	 〈C〉『顔』 / 〈C〉表情,顔つき / 〈C〉(物の)『表面』(surface),(建物の)正面(front),(貨幣・カードなどの)表《+『of』+『名』》 / 〈C〉(…の)外観,様子《+『of』+『名』》 / 〈U〉面目,面子(めんつ) / 〈C〉(多角面体の)面 / 〈C〉(活字・版の)面(印刷する部分);(活字の)書体 / 〈C〉(鉱山の)採掘現場 / …‘に'『面する』,‘の'ほうを向く / (…のほうに)…‘を'向ける《+『名』+『toward』+『名』》 / 〈人が〉〈危険など〉‘に'直面する,立ち向かう,対抗する;〈危険などが〉〈人〉‘に'迫る / 〈事実・現実など〉‘を'直視する,認める / (…で)〈壁など〉‘に'上塗り(上張り)をする《+『名』+『with』+『名』》 / (ある場所・方角に)面する,向く《+『on』(『to』,『toward』)+『名』》
fact	 〈C〉『事実』,実際にある(あった)事 / 〈U〉真相,真実(truth) / 《the~》(法律用語で)犯行 
fade	 『衰える』,弱くなる;〈植物が〉『しぼむ』,しおれる / 『しだいに消えてゆく』,姿を消す《+『away』》 / …‘を'衰えさせる;…‘の'色をあせさせる / 〈映像・音〉をしだいに消えさせる
fail	 『失敗』する,しくじる;落第する / 不足する,欠けている / 『衰える』,弱くなる / 〈会社などが〉破産する,倒産する / (いざというときに)〈人〉‘の'『役にたたない』,期待を裏切る,〈人〉‘を'見捨てる / 〈教師が〉〈学生・生徒〉‘を'落とす,‘に'落第点をつける / 〈学科・試験など〉‘に'『落第する』 / =failure
fain	 喜んで(…したいのだが) 
fair	 《米》(農産物・家畜などの)『品評会』;(一般に)『博覧会』 / 《英》定期市,縁日(特に祭日などに定期的に開かれ,見世物などが出てにぎわう) / 慈善市(bazaar) 
fake	 《話》…‘の'ふりをする,‘を'装う / …‘を'でっち上げる;(絵・紙幣など)‘を'偽造する,‘に'手を入れてごまかす / (…に)見せかける,(…の)ふりをする / にせ物,偽造(模造)品 / いかさま師,詐欺師 / にせの,偽造(模造)の
fame	 『名声』,高名,声望 / 評判,世評
fang	 (肉食動物の)きば,犬歯 / 蛇の毒牙 / (きばのように)とがった先 
fare	 〈C〉(乗り物の)『料金』,運賃 / 〈C〉(料金を払って乗る乗客) / 〈U〉食物,料理 / 〈人が〉やっていく / 《古・文》《itを主語にして》〈事が〉運ぶ,成り行く 
farm	 『農場』,農園(通例住宅・納屋などを伴い,しばしば家畜も飼育される) / (家畜の)『飼育場』,(魚貝の)養殖場 / 〈土地〉‘を'耕作する;〈農場・飼育場〉‘を'経営する 
faro	 銀行(賭けカードゲームの一種) 
fart	 おならをする / おなら,屁(へ)・いやな奴・愚かな人・むかつく奴・ろくでなし・「old fart」として「糞じじい・糞ばばあ」
fast	 『速い』,急速な,すばやい,敏速な / (時計が)『進んでいる』 / 『しっかりした』,ぐらつかない / 心の変わらない,忠実な(faithful) / (色が)あせない / 《古》(女性が)身持ちの悪い;《まれに》(生活が)享楽的な / (フイルムが)高感度の,(レンズが)高速撮影用の / 『速く』;すばやく(quickly) / 『しっかりと』,固く(firmly) / 『ぐっすりと』(soundly) / どしどし,ひっきりなしに 
fate	 〈U〉『運命』,宿命 / 〈U〉(運命として定められた)最期,破滅,(特に)死 / 《the Fates》(ギリシア・ローマ神話の)運命の三女神(Clotho,Lachesis,Atropes) / …‘を'運命づける
faun	 フォーン(ローマ神話の林野・牧畜の神で半人半羊の姿をし,みだらな性質をもつといわれる;ギリシア神話ではsatyrと呼ばれる) 
fawn	 〈C〉(1歳以下の)子ジカ,(特に)黄ジカの1歳児 / 〈U〉淡黄茶色 / 淡黄茶色の 
faze	 …‘の'心を騒がせる,‘を'あわてさせる,‘を'たじろがせる 
fear	 〈C〉〈U〉『恐れ』,恐怖(dread) / 〈C〉〈U〉『不安』,心配,気づかい(anxiety) / 〈U〉(神に対する)おそれ,崇敬(awe) / …‘を'『恐れる』,こわがる(進行形にできない) / …‘を'『気づかう』,あやぶむ / 《古》〈神など〉‘を'恐れる / 恐れる,こわがる / (…を)気づかう,心配する《+『for』+『名』》
feat	 『手柄』,功績 / 芸当,離れ業
felt	 feelの過去・過去分詞 
fend	 …‘を'避ける / 抵抗する
fern	 シダ;《集合的に》シダの群生 
feud	 (長く続く)不和,反目 / (2家族間で)反目する
fiat	 (権力者の)命令,布告;(…という)命令《+『that節』》 
file	 やすり / …‘に'やすりをかける;…‘を'やすりで切る(削り取る)
film	 〈C〉(…の)『薄皮』,薄膜,薄い層《+『of』+『名』》 / 〈U〉〈C〉(写真の)『フイルム』 / 〈C〉《おもに英》『映画』;《the films》《集合的に》映画 / …‘を'薄膜でおおう / …‘を'フイルムに写す,(映画に)撮影する / 〈小説など〉‘を'映画化する / (ほこり・氷などで)うっすらとおおわれる《+『over with』+『名』》 / 映画化される
find	 (偶然に)…‘を'『見つける』(進行形にできない) / …‘を'『見つけだす』,捜しだす(進行形にできない) / 〈今まで知られていない事・物〉‘が'『分かる』,知る,気がつく《+『名』+『out,』+『out』+名》 / 《しばしば受動態で》…‘が'存在することを知る / …‘に'届く,達する / 〈評決・判決〉‘を'下す,裁定する / …‘を'支給する;(…を)…‘に'支給する,供給する(provide)《+『名』+『in』+『名』》 / (特に,貴重な)発見物,掘出し物
fine	 罰金 / 〈人〉‘に'罰金を科する:
fink	 密告者 / ストライキ破り / 卑しい人間,いやなやつ 
fire	 『火』,炎 / 〈C〉『燃えているもの』,炉火,たき火 / 〈C〉〈U〉『火事』,火災 / 〈U〉(火のような)熱情,情熱 / 〈U〉(鉄砲などの)発射,射撃,砲火 / <炉など>‘に'『燃料をくべる』,‘の'火をたく《+『up』+『名,』+『名』+『up』》 / …‘に'『火を付ける』,‘を'燃やす / <陶器など>‘を'焼く,焼いて作る / (…に向けて)<銃砲など>‘を'撃つ,<弾丸・ロケットなど>‘を'発射する《+『off』+『名』(+『名』+『off』)+『at』+『名』》 / (…で)<感情など>‘を'燃え立たせる,<人>‘を'興奮させる《+『名』+『with』+『名』》 / 《話》(…)<石・ボールなど>‘を'投げつける,<質問・批評など>‘を'浴びせる《+『名』+『at』+『名』》 / 《話》(…から)<人>‘を'首にする,解雇する(dismiss)《+『名』+『from』+『名』》 / (…に向かって)<人が>『発砲する』,<銃などが>発射される《+『名』+『at(into,on,upon』)+『名』》 
firm	 (物が)『堅い』,堅固な,引き締まった / 『しっかり固定した』,ぐらつかない / (人・信念・友情などが)変わらない / 断固とした,決然たる / (価格・価値が)安定している / しっかりと / …‘を'固める,堅くする《+『up』+『名,』+『名』+『up』》 / …‘を'安定させる / 安定する《+『up』》 
fish	 {C}『魚』;《集合的に》魚類 / {U}魚肉,魚 / {C}《話》人,やつ / 〈魚〉‘を'『とる』,釣る,捕まえる;〈小川・湖など〉‘で'魚をとる,漁をする / 釣りをする,魚をとる,漁をする 
fist	 『握りこぶし』,げんこつ 
five	 〈C〉(数の)『5』;5の記号(5,Vなど) / 〈C〉5時,5分;5歳 / 〈U〉《複数扱い》5人,5個 / 〈C〉5人(5個)1組のもの / 〈C〉(カードの)5の札 / 『5の』,5個の;5人の / 《補語にのみ用いて》5歳の(で) 
flab	 筋肉などのたるみ(ゆるみ) 
flag	 (国家・団体などを象徴する)『旗』;(信号用の)旗 / …‘に'旗を立てる,‘を'旗で飾る / 〈人・車など〉‘に'旗(手)を振って止める《+『名』+『down』,+『down』+『名』》 
flak	 対空砲[火] / 非難攻撃
flan	 フラン(果物・チーズ入りパイ) 
flap	 〈帆・旗などが〉『はためく』 / 『羽ばたく』 / 〈翼など〉‘を'羽ばたかせる,パタパタ(ハタハタ)と動かす / (平たくしなやかなもので)…‘を'ぴしゃりと打つ / ピシャりとたたくこと / (片方だけ留めて)垂れ下がった薄いもの;(特に)(ポケットの)垂れぶた,(封筒の)折り返し / (飛行機の)下げ翼 / 《話》興奮状態
flat	 平『平らな』,平たんな / 《補語にのみ用いて》べったりと広がった(横になった) / 薄っぺらな(shallow) / 《名詞の前にのみ用いて》露骨な,あからさまな;(positive) / (料金・価格などが)均一(一律)の(uniform) / たいくつな,おもしろくない,気の抜けた / (発泡飲料が)気の抜けた / 空気のはいっていない,しぼんだ / (絵画で色調が)変化に乏しい,光沢を消した / (音楽で)変音の,半音下がった / 『きっぱりと』 / 正確に,きっかり / 本来の音程より下げて / 『平面』,平たい部分 / 平地,低地;《複数形で》湿地,沼地,浅瀬 / 枠張り物(舞台背景用のベニヤ・布などを張った枠組み) / 《おもに米》空気の抜けたタイヤ;パンク / 半音低い音,変音;変音記号
flaw	 (ガラス・陶器などの)割れ目,ひび,傷 / (…の)欠点,欠陥《+『in』+『名』》 / …‘に'傷をつける / 傷ができる
flax	 亜麻 / 亜麻の繊維(リンネルがつくられる)
flay	 〈生き物〉‘の'皮をはぐ / …‘を'厳しくしかる
flea	 ノミ 
fled	 fleeの過去・過去分詞 
flew	 flyの過去形 
flex	 (仕事などを始める準備運動として)〈手足など〉‘を'曲げる,〈筋肉〉‘を'縮める 
flip	 …‘を'はじく,ぽんとほうり上げる,はじき上げる / …‘を'くるっとひっくり返す《+『over』+『名,』+『名』+『over』》 / ぽんとはじける,ぐいと動く / 《俗》興奮してぴくっとする / はじくこと,ぱちんとひっくり返すこと / (言葉などが)軽薄な;生意気な
flit	 〈鳥・コウモリなどが〉すいすい(ひらひら)飛ぶ / 〈思い・表情などが〉かすめる / すいすい(ひらひら)飛ぶこと 
floe	 浮氷塊;(浮氷塊から割れた)浮氷片 
flog	 (特にこらしめのために)…‘を'むち打つ 
flop	 ばったりと倒れる,どさりと腰かける / パタパタ動く / 《話》失敗する / …‘を'どさっと投げる / ばったり落ちる(倒れる)こと / どさっと落ちる音 / 《話》大失敗;失敗者 
flow	 《副詞[句]を伴って》〈気体・液体・電気などが〉『流れる』 / 《副詞[句]を伴って》〈言葉・人々などず〉流れるように続く / 〈心・場所などが〉(…で)いっぱいになる,満ちあふれる《+『with』+『名』》 / 《副詞[句]を伴って》〈髪・服などが〉長く垂れる;風になびく / 〈潮が〉満ちる / (…から)生じる,発生する《+『from』+『名』》 / 〈C〉《単数形で》(気体・液体・電気などの)『流れ』《+『of』+『名』》 / 〈C〉《単数形で》(言葉・人などの)絶え間のない(よどみのない)流れ《+『of』+『名』》 / 〈C〉《単数形で》(…の)洪水,はんらん《+『of』+『名』》 / 〈U〉《the flow》満ち潮,上げ潮
flub	 …‘を'失敗する,‘で'へまをやる / 失敗する,へまをやる / 失敗,へま 
flue	 煙突などの煙・蒸気・排気ガスなどの)通路,導管;(煙突の)煙道,(煙管ボイラーの)炎管 
flux	 流動,流れ;上げ潮 / 絶え間ない変化,流転(るてん) / 融剤,フラックス / (流体・粒子・エネルギーの)流量,流束,流動率 / (電気・磁気の)束(そく) / (体内の液体の)異常流出,異常排出
foal	 ウマ科の動物(馬・ロバ・シマウマなど)の子;(特に)ウマ科の動物の1歳未満の子 / 〈雌馬が〉子馬を生む / 〈雌馬が〉〈子馬〉‘を'生む 
foam	 (液体表面の)『泡』(あわ)[のかたまり] / 《話》=foam rubber / 『泡立つ』 / 泡立って流れる(吹き出る)
foci	 focusの複数形 
fogy	 時勢遅れの人,がんこで旧弊な人 
foil	 〈U〉金属の薄片,箔(はく) / 〈C〉(比較・対照により他者の)引き立て役となる人(物)《+『for(to)』+『名』》
fold	 《副語[句]を伴って》〈紙など〉‘を'『折る』,折り重ねる / 〈両手など〉‘を'『組む』;〈鳥が〉〈翼〉‘を'畳む / (…に)…‘を'巻き付ける《+『around(about)』+『名』》 / …‘を'抱き締める(embrace) / 《副語[句]を伴って》〈扇などが〉折リ畳める / 《話》〈事業などが〉つぶれる,閉じる《+『up』》 / ひだ / 折り目,畳み目 / (土地の)くぼみ / 起伏
folk	 《米はしばしば複数形で》(住所・年齢・境遇などの特殊な)『人々』 / 《米はしばしば複数形で》(一般の)人々,世人(people) / 《話》《one's folks》『家族』;親族;両親 / 《古》民族,種族;国民 / =folk song / 《話》《呼び掛けに用いて》皆さん,お立ち合い / 民衆(庶民)に起源を持つ,民衆(庶民)の;民俗の 
fond	 《補語にのみ用いて》(…を)『好んで』,好きで《+『of』+『名』(do『ing』)》 / 《名詞の前にのみ用いて》『優しい』,愛情のある(loving) / 《名詞の前にのみ用いて》優しすぎる,甘い / 《名詞の前にのみ用いて》(希望など)深く心に抱いた,ひとりよがりの
font	 (教会で洗礼用の水を入れる)洗礼盤 / 《詩・文》泉(fountain);源泉(source)
fora	 forumの複数形 
fore	 (乗り物の)前部の,前方の / 船首に,(へ) / 前部,前面 
fork	 (食卓用の)『フォーク』 / くま手,またぐわ / (川・道路などの)分岐点;別れ道,分流,分枝 / 〈干し草など〉‘を'くま手でかき上げる(刺す) / (川・道路・枝などが)分岐する / 〈人が〉(左右の)別れ道をとる
form	 〈C〉〈U〉(色・材質に対して)『形』,形状,姿 / 〈C〉『人体』,体つき / 〈C〉〈U〉『外観』,格好,人影 / 〈C〉〈U〉(ものの現れる)『形態』,形式 / 〈C〉(生物などの)『種類』,品種 / 〈U〉(芸術作品の)表現形式 / 〈U〉(特にスポーツで)(競技者の)フォーム / 〈U〉(心身の)調子,元気 / 〈C〉(印刷された)書き込み用紙,ひな形 / 〈U〉《話》(ある集団などの)やり方,仕方,方式 / 〈C〉〈U〉しきたり,伝統的な儀式 / 〈C〉(英国の学校・米国のある学校で)学年,学級 / 〈U〉〈C〉(意味に対する)形態,形;語形 / 〈C〉(通例寄りかかりのない)長い木のいす / 〈素材〉‘に'形を与える,(…に)…‘を'形作る《+『名』+『into』+『名』》 / (素材から)…‘を'形作る《+『名』+『out of』+『名』》 / …‘を'組織する,構成する / 〈考えなど〉‘を'まとめる,思い付く;〈計画など〉‘を'立てる / 〈習慣など〉‘を'身に付ける;〈交際など〉‘を'結ぶ / 〈文章など〉‘を'組み立てる;〈複数形など〉‘を'作る / (ある順序に)配列する,整列させる / 〈物が〉形を成す / 生じる,現れる / (…に)なる《+『into』+『名』》
fort	 『とりで』,堡塁(ほるい) 
foul	 『汚い』,不潔な(dirty);不快な,むかつくような / (行為などが)『邪悪な』;(言葉・話などが)下品な,みだらな / 《名詞の前にのみ用いて》(競技で)『反則の』;(野球で)ファウルの / (天候が)悪い / 《名詞の前にのみ用いて》(パイプ・煙突などが)詰まった / 《話》いやな,ひどい / 不正に,違法に / 〈C〉(競技の)『反則』 / =foul ball / 〈物・場所など〉‘を'汚す,〈評判・名声など〉‘を'汚す / 〈ロープなど〉‘を'もつれさせる,からませる / (競技で)〈相手〉‘に'対して反則行為をする;(野球で)〈投球〉‘を'ファウルする / 汚れる / 〈ロープなどが〉もつれる;〈網などが〉(…に)からまる《+『on』+『名』》 / (競技で)反則をする;(野球で)ファウルを打つ 
four	 〈C〉(数の)4;4ノ記号(4,IVなど) / 〈U〉4時,4分;4歳 / 〈U〉《複数扱い》4人,4個 / 〈C〉4個(4人)1組のもの;フォア(4本オールのボートおよびその選手) / 〈C〉(カードの)4の札 / 4の;4人の;4個の / 《補語にのみ用いて》4歳の(で) 
fowl	 {C}にわとり(鶏)(アヒル・七面鳥など)家で飼う鳥) / 《修飾語を伴って》《集合的に;複数扱い》 / 〈U〉鶏肉,鳥肉 
foxy	 悪賢い,ずるい 
frag	 (手投げ弾で)〈気にくわぬ上官〉‘を'粉々にしてやる,襲う 
fray	 騒々しいけんか,争い 
fret	 (…のことで)『いらいらする』 / 〈人・人の心〉‘を'『悩ます』 / 〈さび・水などが〉〈物〉‘を'浸食する;〈虫などが〉〈物〉‘に'食い込んで穴をあける / いらだち,焦り;苦労,苦悩
frog	 『カエル』 
from	 《場所》…『から』 / 《範囲》 / 《時》…『から』 / 《運動・行動などの起点》 / 《範囲》 / 《数量・価格》…『から』 / 《分離・隔たり》…『から』 / 《状態の変化》…『から』 / 《起源・出典・由来・出身》…『から』 / 《原因・理由・根拠》…『から』;…で,によって / 《原料》…『から』 / 《相違・区別》…『と』[『違って』] / 《除去・選択・解放・奮取》…『から』 / 《抑制・妨害》…[すること]『を』《+do『ing』》 / 《副詞・前置詞句・名詞節を伴って,方向》…『から』 
fuck	 性交する / [男性が]…‘と'性交する / 性交 / 性交するためだけの女 / いらいらする時などに発する強勢語 
fuel	 〈U〉『燃料』;〈C〉(特定の種類の)燃料 / 〈U〉(感情などを)たきつけるもの《+『to』(『for』)+『名』》 / 〈炉・船など〉‘に'燃料を供給する / 〈船・飛行機などが〉燃料を補給する《+『up』》
fume	 (悪臭を放つ)煙,ガス,蒸気 / 〈煙・ガス蒸気が〉出る,煙る / 怒る,いらだつ 
fumy	 煙を出す,蒸気の多い 
fund	 (特定の目的のための)『資金』,基金《+『for』+『名』》 / 《a ~》(すぐに役立つ知職などの)『蓄え』,蓄積(stock)《+『of』+『名』》 / 《複数形で》手元資金,所持金;《英》公債,国債 / 〈事業・研究など〉‘に'資金を提供する / 〈負債〉‘を'長期公債にする 
funk	 《a ~》《話》おじけ / おくびょう者 / 〈物事〉‘に'おじけづかせる / 怖がる,しりごみする
furl	 〈旗・帆など〉‘を'巻く;〈傘・扇子・翼など〉‘を'畳む / 巻かれる,畳まれる
fury	 〈C〉〈U〉(抑えきれないほどの)『激しい怒り』,激怒 / 《単数形で》(天候・戦争・病気などが)激しく荒れ狂うこと,猛威 / 〈C〉《話》激しい気性の人(特に女性) / 《F-》復しゅうの女神の一人
fuse	 ヒューズ / (またfuze)(爆発物などの)信管,導火線
fuze	 =fuse2 
gain	 (努力して)…‘を'『得る』,手に入れる / …‘を'『増す』 / 〈競争など〉‘に'勝つ;〈賞など〉‘を'勝ち取る / 《文》(特に努力をして)〈目指す場所〉‘に'到達する;〈目的など〉‘を'達成する / 得をする / (…において)進歩する,よくなる,向上する;(体重・身長・能力など)増す《+in+名》 / 〈時計が〉進む / 〈C〉(…に)加えたもの《+『to』+『名』》;(…において)増加したもの《+『in』+『名』》 / 《複数形で》『利益』(profits);賞金 / 〈U〉利益を得ること,獲得
gait	 歩きぶり,足どり 
gale	 『強風』 / 《しばしば複数形で》(笑いなどの)爆発《+『of』+『名』(do『ing』)》
game	 〈C〉『遊び』,遊戯 / 〈C〉『競技』,試合;《複数形で》競技[大]会 / 〈C〉(1試合の一部をなす)1ゲーム,1勝負 / 〈C〉〈U〉試合ぶり,ゲーム運び / 〈U〉(試合途中の)得点 / 〈C〉ゲーム用品,遊び道具 / 〈C〉(商売などの)競争 / 〈C〉計略,策略 / 〈U〉〈C〉冗談,たわむれ,いたずら / 〈U〉《集合的に》猟の獲物;獲物の肉 / 〈U〉《米話》職業,仕事,商売 / 闘志のある,勇気のある / 《補語にのみ用いて》《話》元気(気力)がある / かけ事(とばく)をする(gamble)
gamp	 ばかでかい雨がさ 
gaol	 =jail 
gape	 (…に)口をぽかんとあけて見とれる《+『at』+『名』》 / (あくびなどで)口を大きくあける / 〈地面・貝・傷などが〉大きな口をあける,ぱっくり開く / 〈C〉口をぽかんとあけて見とれること / 〈C〉割れ目,裂け目 / 〈U〉《the gapes》張嘴(ちょうし)病(口ばしを開いたまま死ぬ鳥の病気) / 〈U〉《the gapes》あくび[の発作] 
garb	 (時代・国・職業などに特有な)服装 / …‘に'着物を着せる
gash	 大きく深い傷(切り傷) / …‘を'深く切る,‘に'深い傷を負わせる
gasp	 (…に)(驚き・恐怖・怒りなどで)『はっと息をのむ』《+『with』(『in』)+『名』+『at』+『名』》 / あえぐ,ハアハアと息を切らす / …‘を'『あえぎながら言う』《+『名』+『out,』+『out』+『名』》 / 『あえぎ』,息切れ;(驚きなどで)はっと息をのむこと;息が止まること
gate	 (…への)『門』,通用門《+『to』(『of』)+『名』》;(門の)とびら / (ダム・運河などの)水門 / (競技場・劇場などの)[有料]入場者数 / (またgate money)総入場料
gave	 giveの過去形 
gawk	 (…を)ぽかんと見つめる《+『at』+『名』》 
gawp	 (口を開けて)(…を)ぽかんと見詰める《+『at』+『名』》 
gaze	 (…を)『じっと見つめる』,凝視する《+『at』(『into,on,upon』)+『名』》 / 『じっと見詰めること』,凝視
gear	 〈C〉(動力を伝動する)『歯車』,ギヤ / 〈U〉歯車装置,伝動装置,ギヤ / 〈U〉(特定の機能を果たす)装置 / 〈U〉(ある仕事・活動のための)道具一式 / …‘に'ギヤ(伝動装置)を取り付ける / (…に)…‘を'かみ合わせる,連係させる《+『名』+『to』+『名』》 / (…に)ギヤがかみ合う《+『into』+『名』》 
geld	 〈動物,特に馬〉‘を'去勢する 
gens	 (古代ローマの)氏族(共通の姓を持つ集団) 
gent	 紳士,だんな 
germ	 細菌,ばい菌 / (植物の)胚(はい),幼芽;(動物の)卵子 / 原因;(発達の)初期 
gibe	 (人・行為などを)ばかにする,あざける《+『at』+『名』〈人〉,+『about』+『名』〈行為など〉》 / …‘を'ばかにする,あざける / (人・行為への)あざけり,からかい《+『at』+『名』〈人〉,+『about』+『名』〈行為など〉》 
gift	 〈C〉(…への)『贈り物』,寄贈品,寄付金《+『to』(『for』)+『名』》 / 〈C〉(…に対する)『生まれつきの才能』,天賦の才《+『for』(『of』)+『名』(do『ing』)》 / 〈U〉《古》与えること,贈与;(権力者などが持つ地位などを)与える権限 
gild	 …‘に'金ぱくをかぶせる,金めっきをする;…‘を'金色に塗る / (…で)…‘を'美しく飾る《+『名』+『with』+『名』》
gilt	 gildの過去・過去分詞 / 金めっきした,金色に塗った(gilded) / 金ぱく,金粉,金泥(きんでい) 
gimp	 〈U〉脚が悪いこと / 〈C〉脚の悪い人;(一般に)身障者
gird	 〈帯など〉‘を'締める;(帯などで)〈腰など〉‘を'巻く《+『名』+『with』+『名』》 / (…で)…‘を'取り巻く,囲む《+『名』+『with』(『by』)+『名』》 / (…に)〈自分〉‘を'身構えさせる《+one『self for』+『名』》;(…しようと)〈自分〉‘を'構える《+one『self to』 do》 
girl	 『女の子』,『少女』,娘,未婚の若い女性 / 女店員,女事務員,お手伝い / 《one's ~》《話》恋人,ガールフレンド / (一般的に)女(woman) / 《話》娘(daughter) 
giro	 (英国の)銀行振替制度 / (英国の)郵便振替制度
girt	 girdの過去・過去分詞 
gist	 要旨,要点 
give	 (無償で)〈物〉‘を'『与える』,あげる,贈る,提供する / 〈物〉‘を'『渡す』,手渡す(hand over) / 〈代金〉‘を'『支払う』 / 《抽象的なことを目的語にして》…‘を'『与える』,授ける,出す / 《『give』+『名』〈間〉+『名』〈直〉》…‘に'〈体の一部〉‘を'差し出す / …‘を'供給する;…‘を'生ずる,もたらす / 〈数量・兆候など〉‘を'示す / 《特に短い動作を表す名詞を目的語にしてgive a~の形で》…する / 〈会など〉‘を'催す,開く;〈劇など〉‘を'上演する / (…のために)…‘を'ささげる《+『名』+『for』(『to』)+『名』》 / (…に)〈努力・注意など〉‘を'向ける,注ぐ《+『名』+『to』+『名』》 / 《『give』+『名』+『to』do》…‘に'(…)させる / (…に)『物を与える』,寄付する《+『to』+『名』》 / 力に屈する,妥協する / (力を受けて)へこむ,たわむ;つぶれる / (材料などの)弾力性;(性格などの)順応性,協調性
glad	 《補語にのみ用いて》『うれしい』,楽しい,喜んで / 《『be glad to』 do》《未来形で》『喜んで』(『進んで』)…『する』(willing) / 《名詞の前にのみ用いて》(物事・表情・声などが)『喜ばしい』,うれしそうな 
glen	 (人里離れた)峡谷,谷間 
glib	 (人が)口のたっしゃな,(舌などが)ぺらぺらとよく回る / (言い訳などが)ぺらぺらと口先だけの
glob	 (液体の)小滴,しずく / (粘土・クリームなどの)球形の固まり
glop	 (ごた混ぜの)どろりとしたもの 
glow	 (炎を上げずに)『赤々と燃える』 / 光を放つ,輝く / 〈花・木の葉などが〉燃えるような色を呈する / (運動後などに)〈顔・体が〉『ほてる』,ぽかぽかする,紅潮する / (感情・誇りなどで)燃える,熱する《+『with』+『名』》 / (高温の炎が出す)『輝き』 / (色彩の)『燃えるような鮮やかさ』 / 《時にa ~》(体の)『ほてり』,(顔の)紅潮 / (感情の)高まり,熱情 / 満足感,喜び
glue	 『にかわ』,にかわ剤;(一般に)接着剤 / …‘を'にかわで付ける / 《しばしば受動態で》(…に)…‘を'くっ付けて離さない(離れない),〈視線など〉‘を'くぎ付けにする《+『名』+『to』(『on』)+『名』》 
glum	 むっつりした,不機嫌な 
glut	 (…を)〈人〉‘に'飽きるほど食べさせる;(…で)〈食欲など〉‘を'十分に満足させる《+『名』+『with』+『名』》 / (生産物などを)〈市場〉‘に'過度に供給する《+『名』+『with』+『名』》 / (生産物などの)過剰供給,過多《+『of』+『名』》 
gnat	 ブヨ;《英》家蚊(mosquito) 
gnaw	 〈動物が〉…‘を'『かじる』;…‘を'かじり取る《+『away』(『off』)+『名』,+『名』+『away』(『off』)》 / (…に)〈穴〉‘を'かじってあける《+『名』+『through』(『in』)+『名』》 / 〈心労・病気などが〉〈人・心など〉‘を『悩ます』,苦しめる(torment) / 〈動物が〉(…を)『かじる』《+『at』(『on,through』)+『名』》 / 〈心労・病気などが〉(人・心などを)苦しめる,悩ます《+『at』(『in』)+『名』》 
goad	 (家畜を追うための)突き棒 / (人を行動などへ)駆り立てるもの,刺激 / …‘を'突き棒で突く / …‘を'刺激する,責め立てる
goal	 『ゴール』,決勝点 / (ゴールに球を入れて得た)得点 / =goalkeeper / 『目標』(aim),目的;目的地
goat	 『ヤギ』 / 《米話》=scapegoat / 《俗》好色家 
goby	 通り過ぎること,見て見ぬふり 
goer	 行く人(物) / 《話》新しい事に常に目を向けている人,順応性のある人
goes	 goの三人称単数現在 
gold	 『金』,黄金(おうごん) / 《集合的に》『金貨』(gold coins) / 金銭,富,財宝 / 黄金色,金色 / 《しばしば…of goldの形で》(金のように)価値のあるもの;純真,親切 / 『金の』,金製の / 金色の 
golf	 『ゴルフ』 / ゴルフをする
gone	 goの過去分詞 / 過ぎ去った,行ってしまった / 使い果たした(spent) / 死んだ(dead) / 絶望的な 
gore	 (特に戦い,けんかなどで傷から流れ出た)血,血の塊 
gory	 《文》(戦い・けんかで)流血の,血みどろの / 暴力の,残虐な
gosh	 えっ,おや(軽い喜び・驚きを表す) 
gout	 〈U〉痛風 / 〈C〉(特に血の)滴り,塊
gown	 『ガウン』(特に夜会・公式の席などで着用する婦人用の長いドレス) / (裁判官・教授などの職業・身分などを表す)正服 / ガウン,室内着(nightgown, dressing gownなの総称) 
grab	 …‘を'『ぎゅっとつかむ』,ひったくる・(…を)ひっつかむ《+『at』+『名』》;(…に)さっと手を伸ばす《+『for』+『名』》・不意｛ふい｝につかむ・取り込む・横取りする・逮捕｛たいほ｝する・（人の心）をとらえる・，〈人に〉強い印象を与える・を軽く飲み［食い］する・》〈...を〉大急ぎで取る[利用する]・ひっつかみ・ひったくり 
grad	 (大学の)卒業生 
grew	 growの過去形 
grey	 =gray 
grid	 格子(こうし);焼き網 / グリッド(真空管で陽極と陰極との中間に装置する金属の格子) / 高圧送電線網 / (地図などの)碁盤目
grim	 (顔つき・態度などが)『険しい』,こわい / 『断固とした』,妥協を許さない / 《話》ぞっとする,不快な / 容赦のない,すさまじい
grin	 (軽べつ・満足・興味などの気持ちで)(…に)『歯を見せて[にやりと]笑う』《+『at』+『名』》 / (苦痛・敵意・怒りなどで)(…に)歯をむき出す《+『at』+『名』》 / 歯をむき出した笑い 
grip	 《単数形で》(…を)『しっかり握る』(『つかむ』)『こと』《+『on』+『名』》 / (特にスポーツ用具などの)握り方;握力 / (…に対する)支配力,制御力《+『on』+『名』》 / 《単数形で》(…に対する)『理解力』《+『on』(『of』)+『名』》 / (道具・機械などの)『握り』,取っ手,柄 / 《おもに米》小型の手さげ旅行かばん / =grippe / …‘を'『しっかりつかむ』(『握る』) / 〈人・物・事が〉〈人・関心・注意など〉‘を'つかむ,引きつける / 〈人が〉〈意味・要点など〉‘を'つかむ,理解する
grit	 (機械・食物に混じる)小砂 / 《話》根性,勇気 / …‘を'きしらせる 
grow	 『成長する』,育つ,〈植物が〉生える,茂る / (類・量・程などにおいて)『増大する』,大きくなる / 『しだいになる』 / …‘を'成長させる,大きくする,育てる / …から生じる(起こる) 
grub	 〈木・草の根〉‘を'掘り起こす,根こそぎにする《+『up』(『out』+『名』,+『名』+『up』(『out』)》 / 掘る,掘って捜す《+『around』(『about』)》 / あくせく働く / ウジ,昆虫の幼虫 / 〈U〉《話》食い物 
gulf	 『湾』 / 《詩》深いふち,深淵(えん) / (地位・立場・教養・感情などの)大きな融たり,越え難い溝 
gulp	 〈飲み物・食べ物〉‘を'急いでごくりと飲む,ぐっと飲む《+『down』+『名,』+『名』+down》 / あおる,ごくりと飲む / (…を)ごくりと飲むこと;ごくりと飲む音(量)《+『of』+『名』》 
gunk	 べたべた(ぬるぬる)した不潔なもの,汚物(《英》gunge) 
gush	 〈水・血・言葉などが〉勢いよく噴き出す,ほとばしり出る / 《話》(…について)(大げさに)しゃべり立てる,感情をみなぎらせて話す《+『over』+『名』》 / (液化の)噴出,ほとばしり / 《話》(感情・音・光などの)ほとばしり,激発
gust	 『突風』 / (感情などの)『ほとばしり』;(雨・煙・音などの)『噴出』,突発《+『of』+『名』》
gyve	 足かせ,手かせ 
hack	 《副詞[句]を伴って》(おのなどで)…‘を'たたき切る,めった切りにする / …‘を'たたき切って作る / (…を)たたき切る《+『at』+『名』》 / からせきをする / (…を)たたき切ること《+『at』+『名』》;刻み目,切り傷 / 《おもに米》からせき
haft	 (ナイフ・短刀などの)柄,つか 
hail	 〈U〉『あられ』,ひょう / 《a~》(…の)雨あられ,あらし《+『of』+『名』》 / あられ(ひょう)が降る / (人に)〈石・悪口など〉‘を'雨あられと浴びせる《+『名』+『on』+『名』》
hair	 〈C〉(人間・動物の1本の)『毛』;(植物・昆虫などの)毛 / 〈U〉《集合的に》『髪の毛』,毛,毛髪;(動物の)体毛 / 《a~》1本の毛ほどの量(距離,程度),ごくわずか 
hake	 タラ科の食用魚 
hale	 元気な,達者な(healthy) 
half	 〈C〉〈U〉『半分』,2分の1;約半分 / 〈U〉《時刻を表す数詞と共に用いて》『半』,30分 / 〈C〉《おもに英》(2学期制の学校での)前(後)期 / 〈C〉(競技などの)前(後)半;(野球で1イニングの)表(裏) / 〈C〉=halfback / 『半分の』 / 不十分な,中途はんぱな / 『半ば』,半分[だけ] / 半時間だけ,30分だけ / 不完全に / かなり,ほとんど 
halo	 (月・太陽などの回りに現れる)かさ / (聖像の)光背,後光,光輪
halt	 《a~》『停止』,休止 / 《おもに英》停車場;バス停 / 『停止』(休止)『する』 / …‘を'停止(休止)させる
hand	 『手』(手首から先の部分) / (時計・計器の)針 / 《単数形で》筆跡 / 側,方(side): / 《a~》(…への)援助,手助け《+with(at, to)+名》 / 職工,職人,人手 / 乗組員 / 《前に形容詞を置いて》(…するのが)(じょうずな・へたな)人(+『at』+『名』(『doing』)》 / 《単数形》技量,腕前;(…の)やり方,扱い方《+『at』(『with』)+名》 / 《単数形で》拍手かっさい / 《文》《one's~,the,》結婚の承諾;確約 / (カードの)持ち札;一勝負 / 《しばしば複数形で》所有,管理 / ハンド(馬の高さを測る単位;4インチ) / 《『hand』+『名』〈間〉+『名』〈直〉=『hand』+『名』+『to』+『名』》…‘に'…‘を'『手渡す』,取ってやる / 《副詞[句]を伴って》〈人〉‘に'手を貸す / 手の(に関する),手のための / 手で操作する / 手持ちの 
hang	 《通例副詞[句]を伴って》(…に)…‘を'『掛ける』,下げる,つるす / (ちょうつがいなどで)〈ドアなど〉‘を'取り付ける《+『名』+『on』+『名』》 / …‘を'絞殺する;(犯罪で)…‘を'絞首刑にする / 《話》《damnの遠回しな語として,ののしりの言葉や強意表現に用いて》 / 〈頭など〉‘を'垂れる / (絵などで)〈部屋・壁など〉‘を'『飾る』,覆う《+『名』+『with』+『名』》;〈壁紙など〉‘を'壁に張る / 《副詞[句]を伴って》(…に)『掛かる』,垂れる,ぶら下がる / (ちょうつがいなどで)〈戸などが〉取り付けられている《+『on』+『名』》 / 首をつる,首つり自殺をする;(犯罪で)絞首刑になる《+『for』+『名』(do『ing』)》 / 掛かりぐあい,下がりぐあい,垂れ方
hank	 (糸の)かせ / (糸・髪の毛などの)束,輪
hard	 (物体が)『堅い』,(手触りが)堅固な,しっかりした / 『難しい』,努力を要する / 《名詞の前にのみ用いて》(人が)『精力的な』,勤勉な / 激しい,猛烈な / (生活などが)耐え難い,つらい / (季節・天候などが)厳しい;(雨・風などが)激しい / (人が)厳格な;(行為などが)容赦しない,無情な / (方針・条件などが)妥協(譲歩)しない,厳しい / (感情が)うらみを含む,憤然とした / (体が)筋肉質の,がんじょうな / (紙幣に対して)硬貨の,(小切手などに対して)現金の;(貨幣が)容易に兌換(だかん)できる / (子音が)硬音の(c,gがcome, goのように[k],[g]と発音される) / アルコール分の多い / (水が)硬質の / (エックス線が)透過能力が大きい / 一生懸命に,『熱心に』 / 『強く』,激しく,大いに / やっと,かろうじて / 『堅く』 / ひどく悲んで / 接近して 
hare	 『野ウサギ』(rabbitよりも大きく穴居(けっきょ)性がない) 
hark	 聞く(listen) 
harm	 『害』,『損害』;危害 / (精神的な)害,災い;不幸;不都合 / …‘を'『害する』,‘に'損害を与える,危害を加える 
harp	 たて琴,『ハープ』 / たて琴を弾く
hart	 雄ジカ(特に5歳以上のアカシカ) 
hasp	 (ドア・ふたなどの)留め金,掛け金 / 〈ドア・窓など〉‘に'留め金(掛け金)を掛ける
hast	 =have 
hate	 …‘を'『憎む』,『ひどくきらう』;《話》…‘を'いやだと思う / 憎しみ,憎悪(hatred)
haul	 …‘を'『引っぱる』;…‘を'引きずる《+『up』+『名,』+『名』+『up』》 / (警察などへ)…‘を'引っぱって行く《+『名』+『before』(『to』)+『名』》 / 〈船〉‘の'針路を変える / (…を)引っぱる《+[『away』]『at』(『on, upon』)+『名』》 / 《a ~》引っぱること / 《a ~》《修飾語句を伴って》引っぱられる距離 / 一網の漁獲;《話》(特に盗品の)もうけ 
have	 (また《話》『have got』)〈物〉‘を'『持っている』,所有している(進行形にできない)・(また《話》『have got』)〈親類・友人など〉‘が'『いる』,‘を'持っている,〈召使など〉‘を'かかえている;〈動物〉‘を'飼っている(進行形にできない) ・(また《話》『have got』)(特質・付属物として)…‘を'『備えている』,‘が'ある(進行形にできない) ・(また《話》『have got』)〈感情・意見など〉‘を'持つ,抱く(進行形にできない) ・《『have to』do》(また《話》『have got to』do)…『しなければならない』;《不定文で》…する必要がある・《『have to be』…》…に違いない・〈ある状態〉‘を'経験する,〈病気〉‘に'かかる / …‘を'食べる,飲む,〈たばこ〉‘を'吸う・《動作を表す名詞を目的語にして》《話》〈ある動作・行為〉‘を'する,行う・《『have』+『名』〈人〉+do》《しばしばwill, wouldと共に》〈人〉‘に'(…)させる,してもらう,される / 《『have』+『名』+『過分』》…‘を'(…)させる,される,してもらう・《+『have』+『名』+『形』(『名』,『過分』,do『ing』)〈補〉》…‘を'(…の)状態に保つ,(…の)ままにしておく(進行形にできない) / …‘を'得る,もらう,受ける(進行形にできない) ・〈人・動物が〉〈子〉‘を'産む,もうける・《通例否定文で》…‘を'許す,認める・(財産・社会的地位などを)持っている人;(資源・核兵器を)持っている国
hawk	 『タカ』 / 《話》(国際問題などで)強硬論者,タカ派の人
haze	 〈C〉〈U〉もや,かすみ / 〈C〉(精神の)もうろう / かすむ / …‘を'かすませる
hazy	 もやのかかった,かすんだ / (考えなどが)もうろうとした,はっきりしない
hdbk	 handbook 
head	 (顔を含めた)『頭』,頭部,首;(髪の生えている部分の)頭 / 『頭脳』,頭の働き,知力,才能;理性 / 『長』,指導者,支配者 / (ある物の)頭,上部,先端,先頭 / (川・泉の)源,水源 / (人・動物の)頭数,一人,1頭 / 『首席』,首位 / 《複数形で》(頭像のある)貨幣の表 / 項目,表題(新聞の)見出し / 《米俗》マリファナ常用者 / 長の,指導者の / …‘の'先頭に立つ,‘を'率いる;…‘の'長である / (…の方へ)…‘を'向ける《+『名』+『for』(『toward』)+『名』》 / (サッカーで)〈ボール〉‘を'頭で受ける,ヘディングする / (…に向かって)進む《+for(toward)+名》・「give a head」で「オーラルセックスをする・相手の性器をなめる」 
heal	 〈傷など〉‘を'直す / 〈悩み・不和など〉‘を'いやす,治める / 〈傷などが〉直る《+『up』(over』)》 
heap	 〈C〉(積み重なった物の)『山』,塊,堆積(たいせき) / 《米方》《英語》《a ...,heaps》『たくさん』(の…),多数[量](の…)《+『of』+『名』》 / 《複数形で》《副詞的に》《話》非常に,大いに(much) / …‘を'『積み上げる』,蓄積する《+『up』+『名』,+『名』+『up』》 / (…を)…‘に'山と積む《+『名』+『with』+『名』》 / (…に)…‘を'山と積む,山ほど与える《+『名』+『on』(upon)+『名』》
hear	 〈音〉‘が'『聞こえる』,‘を'聞く(進行形にできない) / 〈人の言うこと〉‘に'『耳を傾ける』,‘を'注意深く聞く(listen);(裁判官などが)…の申し立てを聞く / 〈うわさ・ニュースなど〉‘を'『耳にしている』,聞いている / 『耳が聞こえる』 / 《しばしば命令形で》耳を傾ける,注意を向ける / 『うわさ』(『消息』)『を聞く』
heat	 〈U〉『熱さ』,『暑さ』,熱い状態 / 〈U〉熱度,温度 / 〈U〉(家などの)暖房装置 / 〈U〉熱心,熱烈;(物事の)最高潮《+『of』+『名』》 / 〈U〉(エネルギーとしての)熱 / 〈C〉(競技の)1回,1ラウンド / …‘を'『熱する』,暖める《+『up』+『名,』+『名』+『up』》 / …‘を'興奮させる,怒らせる《+『up』+『名,』+『名』+『up』》 / 熱くなる,暖まる《+『up』》 
heck	 ちぇ,ちくしょう / (強意語として)hellの遠回しの語
heft	 …‘を'持ち上げる / …‘を'持ち上げて重さをみる / 目方,重量 
heir	 (財産・地位などの)『相続人』,跡取り《+『to』+『名』》 / (先人の思想・精神・伝統などを)受け継ぐ人,後継者
held	 holdの過去・過去分詞 
helm	 〈C〉(船の)かじ,操舵(そうだ)装置 / 〈U〉《the~》支配的な地位,指導的な立場
help	 《しばしば副詞<句>を伴って》〈人が〉〈人〉を『手伝う』,『助ける』,の役に立つ / 〈物事が〉〈人・事〉‘に'役立つ,‘を'よくするのに役立つ / …‘を'救う,助ける,救助する / 〈料理など〉‘を'盛り分ける / (料理などを)〈人〉‘に'よそってあげる,ついでやる《+『名』+『to』+『名』》 / 《cannotと共に》…‘を'避ける,防ぐ;…‘を'がまんする,こらえる / 〈人が〉(…を)助ける,手伝う《+『with』+『名』(do『ing』)》 / 〈物事が〉役立つ,助けになる / 〈U〉『助け』,援助,助力;救助 / 〈C〉(…にとって)助けとなるもの(人),役立つもの(人)《+『to』+『名』》 / 〈C〉雇い人,使用人,な手伝い;《米》《集合的に》家政婦 / 〈U〉『救済手段』,防止策
hemp	 麻,大麻(たいま) / 麻の繊維 / 麻から採れる薬品(ハッシッシなど) 
herb	 草,草本 / 薬用(香料)植物
herd	 (動物の)『群れ』《+『of』+『名』》 / 《軽べつして》[the ～] 民衆，下層民《a herdとして》大ぜい(の…)《+『of』+『名』》 / 〈人・動物〉‘を'集める / 〈牛・羊など〉‘の'番をする / 集まる,群がる 
hero	 (偉業・勇敢な行為などで名を知られた)『英雄』,勇士,ヒーロー / (詩・小説・映画などの)『主人公』,主役 / 《米話》=hero sandwich 
hers	 《sheの所有代名詞》『彼女のもの』 / 《of hersの形で》彼女の
hewn	 hewの過去分詞 
hick	 いなか者 / いなかの
hide	 …‘を'『隠す』 / 〈感情など〉‘を'人に知られないようにする,おもてに出さない,秘密にする / 〈物が〉…‘を'見えなくする,おおい隠す / 『隠れる』,潜む / (狩猟・撮影などのため)動物を観察する隠れ場所 
hike	 『ハイキング』(『徒歩旅行』)『する』 / …‘を'ぐいと引っ張り上げる《+『up』+『名,』+『名』+『up』》 / 〈物価など〉‘を'引き上げる / 『ハイキング』,徒歩旅行 / 《米話》(物価などの)引き上げ 
hilt	 (刀剣の)つか,柄 
hind	 雌ジカ,(特に)3歳以上の雌のアカシカ 
hint	 『暗示』,ほのめかし / 《しばしば複数形で》(…に)役に立つ情報,(…に対する)心得,(…の)手がかり《+『for』(『on』,『to』)+『名』(do『ing』)》 / (…の)微量,わずか《+『of』+『名』》 / …‘を'『ほのめかす』 / (…を)ほのめかす《+『at』+『名』》 
hire	 〈人〉‘を'『雇う』 / (金を払って)〈物〉‘を'『借りる』,賃借する / 〈物〉‘を'賃貸しする;〈自分〉‘が'金で雇われる《+『out』+『名』,+『名』+『out』》 / 借り賃,使用料;雇い賃,給料 / (物の)『賃貸し』,賃借り;(人の)雇用 / (人が)雇われて
hist	 (注意・沈黙を促して)シーッ 
hive	 ミツバチの巣箱 / 巣箱に住む一群のミツバチ / 人のおおぜい忙しく集まる所;がやがや集まっている群衆 / 〈ミツバチ〉‘を'巣箱に入れる / 〈みつ〉‘を'蓄える 
hoar	 =hoary 
hoax	 (悪意のない)悪ふざけ / 〈人〉‘を'かつぐ,‘に'一杯くわせる;〈人〉‘を'かついで(…)させる《+『名』+『into』do『ing』》
hock	 (馬・牛などの後脚の)ひざ,飛節・(特に豚の)足肉 
hoke	 …‘を'でっちあげる《+『up』+『名』,+『名』+『up』》 / でっちあげ,たわごと
hold	 (手などに)…‘を'『持つ』,『持っている』,つかむ,つかんでいる・〈人・物〉‘を'『押しとどめる』,押えておく,留めておく・《副詞[句]を伴って》(ある位置・状態に)〈手・足など体の一部〉‘を'『保つ』(keep) ・〈容器などが〉〈物など〉‘を'『入れている』,収容できる(進行形にできない) ・〈重い荷物など〉‘に'耐える,持ちこたえる(bear);〈物〉‘を'支える(support) ・〈職・地位など〉‘を'占める,占めている(進行形にできない) ・〈土地・財産など〉‘を'所有している(進行形にできない) ・〈会など〉‘を'開催する,〈式〉‘を'行う・〈軍隊などが〉〈土地など〉‘を'確保する;(敵などから)〈とりでなど〉‘を'守る《+『名』+『against』+『名』》・〈注意・関心・興味など〉‘を'引きつけておく,引き留めておく・〈考え・意見など〉‘を'心にいだいている・…‘と'考える,信ずる / 『しっかりと付いている』,切れ(折れ)ないでいる・(…に)『しっかりつかまっている』,しがみついている《+『to』+『名』》・(約束・信念などを)固く守る《+『to』+『名』》・《『hold』+『形』〈補〉》(…の)『ままである』・(引き続いて)有効である,当てはまる・〈U〉〈C〉(…を)手でつかむ(握る)こと』,把握《+『of』(『on』)+『名』》・〈U〉(人の心などを)つかむこと,支配[力],掌握《+『on』(『over』)+『名』》・〈C〉つかまるもの,手(足)がかり・(音楽の記号の)フェルマータ
hole	 (壁などにあいた)『穴』,割れ目;(衣類などの)破れ穴,裂け目;(道路などにできた)くぼみ,へこみ / (動物の住む)巣穴 / 《話》あばら家 / (議論・計画などの)欠点(fault) / 《話》窮地,苦境 / ホール(ゴルフで球を打ち込む穴);(球をホールに入れた)得点 / 〈物〉‘に'穴をあける(掘る) / (ゴルフで)〈球〉‘を'打ってホールに入れる(ゴルフで)球を打ってホールに入れる《+『out』》
holy	 『神聖な』,神にささげられた / 信仰のある,神に身をささげた / 《俗》ひどい,はなはだしい / 至高の聖所
home	 〈C〉〈U〉《おもに米》(家族の住む)『家』,住居,わが家 / 〈U〉〈C〉『家庭』,家庭生活 / 〈U〉『生まれ故郷』,長く住んでいる所;故国,本国 / 〈C〉(動物の)生息地,(植物の)原産地;(物・思想などの)発祥地,本場 / 〈C〉(家のない人・病人などの)『収容施設』,ホーム《+『for』+『名』》 / 〈U〉〈C〉決勝点,ゴール;(野球で)本塁,ホーム / 『家庭の』;故郷の / 『国内の』,自国の / ぐさりと急所をつく,胸にこたえる / (スポーツの試合などが)地元(ホームグランド)で行われる / 『家へ』(に);故郷へ(に);本国(母国)へ(に) / (ねらった所に)ずぶりと,深々と / 胸にこたえるほと,ぎくりと / 〈人が〉帰宅(帰国)する;〈ハトなどが〉巣に帰る / 〈誘導単;飛行機などが〉(目標に)向かう,(…へ)誘導される《+『in on』+『名』》 / (特定の場所に)家を持つ,住む / 〈誘導弾・飛行機など〉‘を'誘導する / 〈人〉‘に'家を与える
homy	 =homey 
hone	 砥石(特にかみそり用) / (砥石で)〈かみそりなど〉‘を'研ぐ
honk	 ガンの鳴き声 / (自動車などの)警笛の音 / 〈ガンが〉鳴く / 〈人・自動車が〉警笛を鳴らす / 〈自動車の警笛〉‘を'鳴らす 
hope	 …‘を'『望む』,期待する / 《『I hope』+『that節』》〈私は〉『…だと思う』 / 希望を抱く;(…を)望む,期待する《+『foe』+『名』》 / 〈U〉〈C〉『望み』,『希望』,期待 / 〈C〉期待される人(物) 
hora	 ホラ(イスラエルの伝統的な民族舞踊) 
horn	 〈C〉(牛・羊・ヤギ・シカなどの)『角』;(カタツムリの)触角;(ミミズクの)耳 / 〈U〉(細工の材料としての)角 / 〈C〉角製の物,角笛 / 〈C〉『警笛』 / 〈C〉ホルン(金管楽器で,初めは動物の角で作ったが,現在は金属やプラスチックで作る);フレンチホルモン(French horn);《俗》トランペット / 〈C〉角状のもの;新月(三日月)のとがった先端 / …‘を'角で突く / 角でできた,角製の
hose	 〈U〉《集合的に》《複数扱い》靴下類(ソックスおよびストッキングを含む;商売に用いられる語) / 〈U〉《複数抜い》(昔男性がはいた)半ズボン,長ズボン,タイツ / 〈C〉〈U〉(水まきなどに使う)ホース,注水管 / …‘に'ホースで水をかける《+『down』+『名,』+『名』+『down』》
host	 (…の)大群,大勢《+『of』+『名』》(multitude) 
hour	 〈C〉(60分としての)『1時間』(《略》h,H,hr,複hrs) / 〈C〉(時計で示される)『時刻』,時 / 〈C〉(ある事をする)特定の時間,定刻 / 〈C〉(一般的な)時,時間 / 《複数形》勤務(営業)時間 / 〈C〉1時間の道のり / 〈C〉(授業の)1時間,1時限;(大学などの)履習単位(1週間の授業時間数) / 《the~》現在
hove	 heaveの過去・過去分詞 
howl	 〈犬・オオカミなどが〉(…に向かって)『遠ぼえする』《+『at』+『名』》 / 〈風などが〉『うなる』 / 〈人が〉『わめく』,どうなる,うめく / 〈感情など〉‘を'うめいて表す,〈おどかしなど〉‘を'わめいて言う《+『out』+『名』,+『名』+『out』》 / 《副詞[句]を伴って》わめいて(どなって)…‘を'(ある状態に)する / (犬・オオカミなどの)『遠ぼえ』 / (風などの)ヒューヒュー鳴る音 / (苦痛・怒り・悲しみなどの)『うなり声』,うめき(声);(笑い・おどかしなどの)ほえるような大声
huge	 (かさ・量・程度などが)『巨大な』,ばく大な;《話》たいへんな 
hula	 (ハワイの)フラダンス 
hulk	 無残な姿になった物(倉庫・牢獄などに使われる廃船,装備を取り払った船体・車体など)・老朽船,ぶかっこうな大型船［大男, 荷物］・体の大きい人;かさばるもの 
hump	 〈C〉(背中の)こぶ,(ラクダ・野牛などの)背こぶ / 〈C〉丸い丘(mound) / 〈U〉《the ~》《英話》不きげん,かんしゃく / 〈背〉‘を'丸める / 《英話》…‘を'背にのせて運ぶ 
hung	 hangの過去・過去分詞 
hunk	 (パン・肉などの)大きな塊《+『of』+『名』》 
hunt	 〈野生の鳥・動物〉‘を'『狩る』,〈獲物のいる場所〉‘を'狩る,〈馬・犬など》‘を'狩猟に使う / 〈物・仕事など〉‘を'捜す,見つけようとする / (…を求めて)〈場所〉‘を'くまなく捜す《+『名』+『for』+『名』》 / (…から)…‘を'迫いやる《+『名』+『away』(+『away』+『名』)+『from』(off, out of』)+『名』》 / 『狩りをする』 / (…を)捜し求める《+『for』(『after』)+『名』》 / (…を求めて…を)くまなそ捜す《+『in』(『through』)+『名』+『for』+『名』》 / 『狩り』,狩猟;《英》キツネ狩り / 狩猟隊(会) / (…の)捜索;追求《+『for』+『名』》
hurl	 (…に)…‘を'『強く投げる』,ほうり投げる《+『at』(『upon, against』)+『名』》 / (…に)〈悪口など〉‘を'浴びせる《+『名』+『at』+『名』》 / 投げつけること 
hurt	 〈身体・身体の一部〉‘に'『苦痛を与える』;〈人〉‘に'『けがをさせる』 / 〈物〉‘に'『損害を与える』,〈評判など〉‘を'損なう / 〈人〉‘の'感情を害する,〈人の感情〉‘を'害する / 〈身体の一部が〉『痛む』 / (肉体的・精神的な)痛み(苦痛)を与える / 《話》《否定文で》支障がある,問題となる(matter) / 〈C〉(…による)(身体の)『けが』《+『from』+『名』(do『ing』)》 / 〈U〉(精神の)苦痛 / 〈C〉(物などの)損害;(誇り・感情などを)傷つけるもの《+『to』+『名』》 
husk	 (穀物・果実の)殻,さや,皮;《米》とうもろこしの殻 / 《通例複数形で》無価値なもの,かす / …‘の'殻を取る,皮をはぐ 
hymn	 (神をたたえる)『賛美歌』,聖歌 / (一般に)賛歌,喜び(感謝)の歌 / 〈神〉‘を'賛美歌を歌ってたたえる;〈賛美の念〉‘を'賛美歌を歌って表す 
hype	 …‘を'刺激する,駆り立てる / (不正な手段で)〈評判など〉‘を'高める,強化する / 不正な手段 / (皮下注射による)麻薬中毒者
hypo	 定着液,ハイポ[hypo-sulfiteの短縮形] 
iamb	 =iambus 
ibex	 アイベックス(アルプス・ピレネー山脈の野生のヤギ) 
icky	 不快な,いやな / ねばっこい,べたべたする
idea	 (心に浮かんだ)『考え』,思考;考えること / (はっきりとした)『意見』,信念,見解 / 『案』,計画,着想,意図,ねらい / (哲学上の)概念,理念
idem	 同上,前述の部分 / 同上の,前述の
ides	 (古代ローマ暦で)3・5・7・10月の15日,および他の月の13日 
idle	 (人が)『働いていない』(unemployed),(機械などが)使われていない,(時間が)空いている / (人が)『怠惰な』,怠けている / 価値のない,むだな / 〈人が〉何もしないでいる,ぶらぶらと時間を過ごす《+『about』》 / 〈機械などが〉から回りし続ける,アイドリングする / 〈時間〉‘を'空費する,ぶらぶらして過ごす《+『名』+『away』,+『away』+『名』》 / 〈不景気・ストライキなどが〉〈人・機械など〉‘を'遊ばせる,暇にさせる 
idly	 何もしないで,怠けて,無益に 
idol	 『偶像』,偶像神 / 『アイドル』,崇拝される人(物)
ikon	 =icon 
ilex	 ウバメガシ(常緑のカシの一つ) / 西洋ヒイラギ
inch	 『インチ』(尺度の単位で1/12foot,2.54cm;《略》『in.,in』) / わずかな距離,少量,少額,少し / 《まれ》《複数形で》身長,背たけ / …‘を'少しずつ動かす / 少しずつ動く 
info	 =information 
inky	 まっ黒な / インクのついた
into	 《運動,動作の方向》…『の中へ(に)』 / …に突きあたって / …に加えて,の一員に / 《状態の変化・結果》…『に』,…『へ』 / 《時間の推移》…まで / 《割算に用いて》…を割って
iota	 イオタ(ギリシア語アルファベットの第9字Ι,ι;英語のI,iに相当) / 《an~》《否定文で》少し(の…)《+『of』+『名』》
iron	 〈U〉『鉄』 / 〈U〉鉄のように堅い(強い,冷たい)こと / 〈C〉鉄製の器具 / 〈C〉[電気]『アイロン』 / 〈C〉アイアン(球を打つ部分が金属のゴルフクラブ) / 〈C〉《複数形で》手かせ,足かせ / 《名詞の前にのみ用いて》『鉄の』,鉄製の / 鉄のように堅い(強い,冷たい) / …‘に'アイロンをかける / 〈人が〉アイロンをかける
isle	 《詩》島(island) 
itch	 〈C〉《an~》かゆい感じ,かゆみ;《the~》(皮膚病の)疥癬(かいせん) / 《an~》うずうずする欲望,むずむずする気持ち / 〈人・体の一部が〉かゆい,むずむずする / 《しばしば進行形で》むずむずする,欲しくてたまらない
item	 『項目』;『種目』,品目;箇条 / 『新聞記事』;(新聞記事の)一節 / (項目を数え上げるとき)一つ(…);さらにまた,同様に 
jack	 〈C〉ジャッキ,押上げ万力(まんりき) / 〈C〉ジャック,プラグの差し込み口 / 〈C〉(また『knave』)(カードの)ジャック / 《複数形で》(また『jackstones』)《単数扱い》ジャックス(一種のお手玉遊び) / (また『jackstone』)〈C〉(ジャックスで用いる)6本の角(つの)から成る金属製の駒,小石や動物の骨などの玉 / 《時にJ-》《話》男,やつ(fellow) / 〈C〉雄のロバ(一般に動物の)雄 / 〈C〉(国籍を示すための)船首旗 / 〈U〉《俗》《通例J-》金(かね)(money) / …‘を'ジャッキで持ち上げる(動かす)《+『名』+『up』,+『op』+『名』》
jade	 やせ馬・駄馬・《軽べつして,またおどけて》女・…‘を'疲れ果てさせる・疲れ果てる 
jail	 〈C〉刑務所,牢獄,拘置所 / 〈U〉入獄,拘置 / …‘を'刑務所に入れる,投獄する;…‘を'拘置する 
jape	 ふざける,からかう / からかい,いたずら
jato	 ロケット離陸補助装置(離陸完了時には捨てられる) 
jean	 〈U〉ジーン布(じょうぶなあや織りの綿布) / 《複数形で》ジーパン;(ジーン布製の)作業服
jerk	 (急に)『ぐいっと引っぱる』(『押す』,『ねじる』,『投げる』)『こと』 / (筋肉の)反射運動;けいれん / 《米俗》うぶな人;まぬけ / (重量挙げの)ジャーク / 《運動を表す副詞[句]を伴って》…‘を'『急に引っぱる』(『押す』,『ねじる』,『投げる』) / …‘を'ぶっきらぼうに(投げ出すように)言う《+『out』+『名,』+『名』+『out』》 / 『急に』(『ぐいっと』)『動く』 
jest	 『冗談』 / もの笑いの種 / (…について)冗談を言う《+『about』+『名』》;(…を)あざける,ばかにする《+『at』+『名』》;(人を)からかう,もて遊ぶ《+『with』+『名』》 
jibe	 =gibe 
jilt	 恋人を捨てる女 / 〈特に女性が〉〈恋人・愛人〉‘を'捨てる
jinx	 縁起の悪い人(物),厄病神 / ちょっとした災い,ジンクス / …‘に'不運をもたらす,けちをつける 
jive	 (音楽)スイング;スイング音楽に合わせたダンス / (ジャズ音楽家たちの)隠語,通語 / 《米俗》訳の分からない話,いいかげんな話 / スイング音楽に合わせて踊る
jock	 《話》=disc jockey / 《俗》運動選手(athlete)
john	 手洗い,便所 
join	 〈二つ以上のもの〉‘を'『つなぐ』,結合する《+『名』+『together』(『up』)》;(…に)…‘を'つなぐ《+『名』+『to』(『onto』)+『名』》 / (線などで)〈二つ以上のもの〉‘の'間を結ぶ(つなぐ)《+『名』+『by』(『with』)+『名』》 / (友情・結婚などで)〈人〉‘を'結びつける《+『名』+『in』+『名』》 / 〈川・道などが〉…‘と'いっしょになる,合流する / 〈会など〉‘に'『加入する』 / (…で)〈人〉‘の'『仲間に入る』,‘と'いっしょになる《+『名』〈人〉+『in』(『for』)+『名』,+『名』〈人〉+『in』do『ing』》 / (…に)『加わる』《+『in』+『名』〈事〉/+『in』 『with』+『名』〈人〉》 / (人と…を)『ともにする』《+『with』+『名』〈人〉+『in』+『名』(doing)》 / 〈川・道などが〉『いっしょになる』,合流する / 接合箇所(点,面,線);継ぎ目
joke	 『冗談』,『笑い話』 / からかい,いたずら / こっけいなもの,物笑いの種 / 冗談を言う;冗談で言う
jolt	 …‘を'激しく揺する;(精神的に)〈人〉‘を'がたつかせる / 〈車などが〉ガタガタ揺れる,揺れながら進む《+『on』(『along』)》 / 急な揺れ(振動) / 突然の驚き(衝撃)
josh	 (悪意はなく)〈人〉‘を'からかう / 冗談を言う
jowl	 あご(jaw),(特に)下あご / ほお(cheek)
jump	 《副詞[句]を伴って》(地面などから)『跳ぶ』,跳躍する / 急に(さっと)立ち上がる / (驚き・恐怖などで)(…に)ぎくっ(ぎょっ)として跳び上がる《+『at』+『名』》 / 〈金額・数量が〉急増する,急上昇する / …‘を'跳び越える / 〈人・動物〉‘を'跳躍させる,急に動かす / 《話》…‘に'急に襲いかかる / 〈C〉『跳ぶこと』,跳躍,ジャンプ / 〈C〉(跳び越さねばならぬ)障害物 / 〈C〉一跳びの幅(高さ) / 〈C〉(驚き・恐怖などで)ぎくっと(ぎょっと)すること / 《the jumps》《話》神経的な震え,動揺,いらいら / 〈C〉(…の)急増,急上昇《+『in』+『名』》 / 《the ~》ジャンプ競技 / 〈C〉飛行機からの落下傘降下 
junk	 廃品,くず(古材・古鉄・古紙・ぼろなど) / 《話》(一般に)値打ちのないもの;がらくた(rubbish) / 《俗》ヘロイン / (廃品として)…‘を'捨てる
jury	 《集合的に》『陪審』[『員団』](普通民間人12人から成り,裁判において被告の有罪無罪を評決し裁判所に答申する) / 《集合的に》(コンテストなどの)審査員
just	 (人・行為などが)『正しい』,『公正な』(fair) / (賞罰などが)受けるに値する,当然の / もっともな,十分根拠のある / 合法的な,正当な / 『ちょうど』,まさに(exactly, precisely) / 《完了形と共に用いて》『たったいま』[…したばかり] / 《過去形と共に用いて》《おもに米》たったいま[…したばかり] / 《現在[進行]形と共に用いて》ちょうどいま(そのとき)[…するところだ] / 《しばしばonlyと共に用いて》『ようやく』,かろうじて(barely) / 『単に』,ただ(only, merely) / 《命令文で用いて》『ちょっと』,まあ / 《話》全く,断然
jute	 黄麻(おうま),インド麻,ジュート,ツナソ / ジュート(ツナソ)の繊維(帆布・南京袋・ロープなどの材料)
kart	 (競走・娯楽用)ゴーカート 
kayo	 ノックアウト(knockout) / (ボクシングで)…‘を'ノックアウトする
kelp	 ケルプ(コンブ・アラメなど大形の海草の総称) / ケルプ灰(ヨードを含む)
keno	 キーノー(とばくの一種) 
kepi	 ケピー帽(上が平らで筒型のフランスの陸軍帽) 
kept	 keepの過去・過去分詞 
kerb	 =curb3 
kerf	 (のこぎりなどで木につけた)切り込み,ひき目;(枝などの)切り口 
khan	 汗(かん)(モンゴル族・ダッタン族の統領,中世の中国の皇帝の尊称;イラン・アフガニスタン・インドなどの大官の尊称) 
kiln	 (れんが・陶器などを焼く)かま,炉 
kilo	 キログラム(kilogram) / キロメートル(kilometer)
kilt	 キルト(スコットランドの高地人や軍人のはく男子用スカート) 
kind	 『親切な』,『優しい』,思いやりのある 
kine	 雌牛(cows);牛(cattle) 
king	 『王』,国王 / 王にたとえられる人(物),…王,大立て者 / (カードの)キング / (チェスの)キング,王将
kite	 『トビ』(ワシタカ科の猛鳥) / 『たこ』(凧)
kith	 [今は成句のみに用いて] 友人, 隣人, 同胞, 知己; 親戚 (kindred)
knew	 knowの過去形 
knit	 〈織物・服など〉‘を'『編む』 / …‘を'しっかりと組み合わせる《+『名』+『together,』+『together』+『名』》 / 〈まゆ〉‘を'寄せる,しかめる / 『編物をする』 / しっかりと組み合わさる / メリヤス生地;〈C〉編んで作った衣類,メリヤス衣類
knob	 (幹などの)『節』,こぶ / (戸・引き出しなどの)『取っ手』,つまみ,握り / 小高い丘;(バター・石炭などの)丸い小さな塊 
knot	 『結び目』,結び / (リボンなどで作った)飾り結び / (人・物の,通例小さな)群れ,一団 / (板・木材の)節,節目;(筋肉などの)隆起 / 困難(difficulty) / 縁,絆(きずな) / ノット(1時間に1海里(約1,852m)進む速さの単位) / …‘を'『結びなわせる』《+『名』+『together』,+『together』+『名』》 / …‘に'結び目をつける,‘を'結ぶ / (こぶになって)堅く結ばれる,もつれる
know	 (事実として,また知識の上で)…‘を'『知る』,知っている;…‘を'覚えている / …‘を'『見て分かる』,織別できる,の見分けがつく;(…から)…を見て分かる《+『名』+『from』+『名』》 / (経験として)…‘を'『知る』 / 『知る』,知っている,分かっている / 熟知 
kola	 =cola
kris	 クリース(刃身が波形の短剣でマレー人などが武器として用いる) 
lace	 〈C〉(靴・衣類などを締める)『ひも』 / 〈U〉『レース』 / 〈U〉(制服などの装飾用)モール / 〈靴など〉‘を'『ひもで締める』《+『up』+『名,』+『名』+『up』》 / (…で)〈衣類など〉‘に'レース飾りをする,へり飾りをつける《+『名』+『with』+『名』》 / (…を)〈布地など〉‘に'織り混ぜる《+『名』+『with』+『名』》 / (酒を)…‘に'加える《+『名』+『with』+『名』》 / 〈靴・衣類などが〉ひもで締まる
lack	 …‘を'『欠く』,‘が'ない(受動態にできない) / (…になるまでに)…‘だけ'不足する《+『名』+『of』[『being』]+『名』》 / 〈U〉《時にa~》(必要なものの)『欠乏』,不足;(…が)ないこと《+『of』+『名』》 / 〈C〉欠けて(不足して)いるもの
lacy	 レースの,レースのような 
lade	 〈特に,荷など〉‘を'積む / …‘を'ひしゃく(スプーン)ですくう / 荷を積む / ひしゃく(スプーン)ですくう
lady	 (教養・礼儀を身につけ,洗練された趣味をもつ)『淑女』,貴婦人 / 《女性(woman)に対する丁寧な言い方として》『婦人』 / 《L-》《英》…『夫人』,…令夫人(SirまたはLordの称号をもつ貴族の夫人,また公(侯,伯)爵の令嬢に対する敬称) / (一般に)女性,婦人(woman)
laid	 layの過去・過去分詞 ・「get laid」で「セックスをする」
lain	 lieの過去分詞 
lair	 (野獣の)寝ぐら,巣 
lake	 『湖』 
lamb	 〈C〉『子羊』 / 〈U〉子羊の肉 / 〈U〉=lambskin / 《the L-》神の子,キリスト(Christ) / 〈C〉気だてのやさしい(柔和な)人,無邪気な人 / 〈羊が〉子を産む
lame	 『びっこの』,脚の不自由な / (議論・説明などが)貧弱な,おそまつな / (身体[の一部]が)かたく凝った / …‘を'びっこにする;…‘を'不具にする
lamp	 (電気・ガス・石油などの)『ランプ』,灯火,明かり / (照明用以外の)『ランプ』 / (知的・精神的な)光,光明 
land	 〈U〉(海・川・湖に対して)『陸』,陸地 / 〈U〉(性質・用途から見た)『土地』,土壌(ground, soil) / 〈C〉『国』,国土(country) / 〈C〉(特定の)地域の住民,国民 / 《the lands》(特定の)地域,地帯 / 〈U〉〈C〉(財産としての)土地,所有地 / (…に)〈飛行機などが〉『着陸』(『着水』)『する』《+『at』(『in, on』)+『名』》 / (…に)〈船が〉『着岸する』,陸づけする《+『at』(『in』)+『名』》 / (…に)〈人が〉船から上陸する《+『at』(『in, on』)+『名』》 / (ある所・物に)〈物が〉当たって止まる;〈鳥が〉舞い降りる《+『at』(『in, on』)+『名』》 / (悪い状態に)なる,陥る《+『up in』+『名』》 / (…に)〈飛行機など〉‘を'着陸させる《+『名』+『at』(『in, on』)+『名』》 / (…に)〈人・貨物など〉‘を'上陸させる,陸揚げさせる《+『名』+『at』(『in, on』)+『名』》 / (悪い状態に)〈人〉‘を'陥らせる《+『名』+『in』+『名』》 / (陸・船内に)〈魚〉‘を'引き(釣り)上げる / 《話》〈職・賞など〉‘を'得る,獲得する
lane	 『小道』,横町,路地,いなか道 / (船・飛行機などの)航路,(車道の)車線 / (ボウリングの)レーン 
lank	 ひょろ長い / (毛髪が)だらんと生気なく垂れた
lard	 ラード(料理用の豚の脂肪) / 〈料理〉‘に'ラードを加える(塗る) / (風味をつけるため)〈肉など〉‘に'ベーコンをはさむ / (…で)〈話・文章〉‘に'味をつける,あやをつける《+『名』+『with』+『名』》
lark	 『ヒバリ』 
lash	 〈C〉(皮製の)『むちひも』,むち / 〈C〉『むちの一打ち』;《the ~》(昔の刑罰で)むち打ちの刑罰 / 〈C〉(むちのような)素早い動き;(むち打つような)激しい非難,痛烈な皮肉 / 〈C〉まつげ(eyelash) / 〈人・動物〉‘を'『むちで打つ』 / 〈風・雨・波などが〉…‘を'激しく打つ / 〈むち・尾など〉‘を'『激しく振る』 / (言葉で)…‘を'厳しく非難する《+『名』+『with』+『名』》 / 〈人など〉‘を'刺激して(かり立てて)(…)させる《+『名』+『to』(『into』)+『名』》 / (…を)『激しく打つ』《+『at』+『名』》 / (…に)〈雨・風・波などが〉『激しく打ちつける』《+『against』+『名』》 / 〈尾などが〉激しく動く《+『about』》
last	 《the ~》(順序・時間について)『最後の』;(行為・でき事について)最後の / 最後に残った,後のない / 《時を表す語につけて》『すぐ前の』,この前の,昨…,先…;最近の,この,ここ / 『最新の』,最近の / 《the ~》『最も』(…)『しそうにない』,最も(…)でない《+『名』+『to』 do(『that節』『wh-節』)》 / 《the ~》(地位・評価・重要さなどが)最も劣る / (特に人生の)終末の / 《the ~》最大の,この上ない(utmost) / (lateの最上級) / (順序・時間が)『最後に』,いちばん遅く / 『この前に』,最近 / (講演・論文などで)最後に,終りに臨んで / 《the ~》『最後の人』(『物』) / 最近のもの,この前のもの / 『最後』,終り,臨終;(月・週の)終り 
late	 (定刻・通常・予定の時間より)『遅れた』,遅い / (時刻が)『遅い』,遅く始まる,遅くまで続く;夜更けの / (時期が)『遅い』,終りごろの,後期の / 『最近の』,最新の(recent) / 《the~,one's~》『前の』,先の,前任の(former) / 《the~,one's~》『故』…,つい先ごろ死んだ / (定刻などより)『遅れて』,遅く / (時刻が)『遅く』,遅くまで,(特に)夜更けに;(時期が)遅く,終りごろに / 『最近』,近ごろ(recently) 
lath	 木摺(きずり),木舞(こまい)(壁下地などに用いる細長い薄板);《集合的に》木摺,木舞 
laud	 …‘を'高く賞賛する 
lave	 …‘を'洗う(wash),浸す / 〈流れなどが〉〈岸〉‘を'洗う
lawn	 『芝生』[『地』] 
laze	 怠ける,のらくら暮らす / 〈時間〉‘を'のらくらして過ごす《+『away』+『名』,+『名』+『away』》 / のらくらする時間 
lazy	 (人動物が)『怠惰な』,無精な,物ぐさな / (物事が)(人の)怠惰を誘う,けだるい,ものうげな / 動きがのろい / 《名詞的に;the lazy》怠け者[たち]
lead	 《方向を表す副詞[句]を伴って》…‘を'『導く』,案内する / 〈道・灯火などが〉…‘に'道筋を示す;(…へ)…‘を'導く《+『名』+『to』(『into』)+『名』》 / …‘の'先頭になる,1番である / …‘の'『率いる』,指揮する / 〈ある人生・生活〉‘を'経験する,生きる,送る / 『先頭に立つ』,(競技・成績などで)リードスル / 〈人が〉『案内する』,先導する / (…に)〈道などが〉『通じている』《+『to』+『名』》 / (…の)結果となる《+『to』+『名』(do『ing』)》 / 〈U〉《the~》『先頭』,首位 / 〈C〉《a~》相手を引き離した点(時間,距離) / 〈C〉模範,手本(example) / 〈C〉(問題解決の)手がかり,ヒント(clue) / 〈C〉(劇・映画などの)主役,主演俳優 / 〈C〉(新聞報道記事などの本文の前におく要約した)前文,前書き,リード / 先頭の,主要な
leaf	 〈C〉(木・草の)『葉』 / 〈C〉花びら / 〈C〉(本などのページの裏表)『1枚』 / 〈U〉(金属の)薄片,箔(はく) / 〈C〉(折りたたみ式テーブルの)補助板 / 《おもに米》〈木が〉葉を出す《+『out』》 / (本などの)ページをばらばらとめくる,内容にざっと目を通す》+『through』+『名』》 
leak	 〈U〉〈C〉(水・空気・ガス・光などが)漏れること / 〈C〉『漏れ口』,漏れ穴 / 〈C〉(秘密などの)漏えい《+『of』+『名』》 / 〈船・屋根・容器などが〉漏る / (…から,…の中へ)〈水・空気・ガス・光など〉漏れる《+『from』(『into』)+『名』》 / 〈秘密などが〉漏えいする《+『out』》 / 〈水・空気・ガス・光など〉‘を'漏らす / (…に)〈秘密など〉‘を'漏らす《+『名』+『to』+『名』》
lean	 (人・動物が)『やせた』,肉の落ちた / (肉などが)脂肪が少ない / 乏しい,貧弱な(poor, scanty);(土地などが)やせた / 脂肪のない肉,赤身(lean meat)
leap	 《しばしば副詞[句]を伴って》『ぴょんと飛ぶ』,はねる,躍る / 《副詞[句]を伴って》(飛ぶように)『急に』(『す早く』)『動く』,ぴょんと動く / 〈人・動物などが〉…‘を'『飛び越える』 / (…を)〈動物など〉‘に'飛び越えさせる《+『名』+『over』(『across』)+『名』》 / 跳ぶこと,跳躍;《比喩(ひゆ)的に》飛躍,急変 / ひと跳びの距離
lech	 性的快楽にふける / 好色;《米》好色な人
left	 leaveの過去・過去分詞 
lend	 〈金・金〉‘を'『貸す』 / (…に)〈援助〉‘を'与える,〈魅力など〉‘を'添える《+『名』+『to』+『名』》 / 金を貸す,融資する 
lens	 『レンズ』 / (目の)水晶体
lent	 lendの過去・過去分詞 
lest	 …『しないように』,するといけないから / 《fear,danger,afraidなど恐れ・危険を表す動詞・名詞・形容詞の後に用いて》…『ではないかと』(that),という[ことを]
levy	 (…に)〈税金など〉‘を'強制的に課する《+『名』+『on』(『upon』)+『名』》;〈税金など〉‘を'取り立てる / 《文》(…に対して)〈戦争〉‘を'始める《+『upon』(『against』)+『名』》 / (税金などの)強制課税(取り立て);(兵士の)召集 / 取り立てた税金;召集兵,召集軍隊
lewd	 みだらな・わいせつな・好色の 
liar	 『うそつき』 
lice	 louseの複数形 
lick	 (舌で)…‘を'『なめる』 / 〈炎・波などが〉…‘を'なめる / 《話》…‘を'ぶんなぐる,打つ / 《話》…‘を'打ち負かす,征服する / 全速力で進む,急ぐ / (舌での)一なめ / (…の)少量《+『of』+『名』》 / =salt lick / 《話》速力(speed) / 《話》一打ち,一なぐり
lido	 公共野外プール / (水泳・日光溶のための)海岸,湖畔の特定地城
lied	 リード(ドイツの叙情的歌曲) 
lief	 喜んで,進んで 
lien	 (法律で認められた財産などに対する)先取特権,留置権《+『on』+『名』》 
lieu	 場所 
life	 〈U〉(無生物と区別して,生物が持っている)『生命』,命 / 〈U〉《集合的に》『生物』,生き物 / 〈U〉(死後の)霊,霊的存在 / 〈C〉人間(person) / 〈U〉『一生』,生涯 / 〈C〉『寿命』,活動(有効,耐久)期間 / 〈U〉『人生』,現世,世間 / 〈C〉〈U〉『生活』,暮らし,生き方,暮らし方 / 〈C〉『伝記』(biography) / 〈U〉『生気』,活気,元気(vitality)
lift	 (上の位置まで)…‘を'『持ち上げる』,引き上げる《+『up』+『名,』+『名』+『up』》 / …‘を'『上に向ける』《+『up』+『名,』+『名』+『up』》 / (上の程度・段階まで)…‘を'『高める』,上げる《+『up』+『名』,+『名』+『up』》 / 〈禁止令・税金など〉‘を'徹廃する;〈封鎖・妨害など〉‘を'解除する / 《話》(…から)…‘を'失敬する《+『名』+『from』+『名』》 / 〈雲・霧などが〉晴れる / 『持ち上げる(『持ち上がる』)こと』 / (物が)持ち上げられる距離(高さ);持ち上げる重量(分量) / (自動車などに)『乗せること』 / 《通例単数形で》手助け,援助 / 《話》《a~》精神の高揚,感情の高まり / 《英》=elevator / (特にスキーヤーを運ぶ)リフト;起重機 / (飛行機の翼にかかる)揚力 / (靴の)かかとの皮[の1枚] 
like	 …‘を'『好む』,‘が'好きである / 《しばしば否定文で,またwould,《英》shouldと共に用いて》…‘を'望む,…したい / 『好む』;望む / 《複数形で》好み,好きな事
limb	 (動物の)『手足』;(鳥の)翼 / (木の)大枝
lime	 石灰 / 鳥もち(birdlime) / …‘に'石灰をまく;…‘を'石灰で処理する / …‘に'鳥もちを塗る;…‘を'鳥もちで捕らえる
limn	 《古》〈絵〉‘を'かく / 《文》…‘を'言葉で描写する
limo	 =limousine 
limp	 『びっこを引く』 / 〈物事が〉ちぐはぐになる,もたつく / びっこを引くこと 
limy	 石灰質の 
line	 『線』,筋,けい / (色・縫い目などの)『線』,しま;(顔・手などの)しわ(wrinkle) / (物・人の)『列』,行列(row) / 『綱』,糸,針金 / 電線,電話線,電信線 / (文章の)『行』;(詩の)『行』 / 《しばしばa~》《話》『短い手紙』(note) / 《複数形で》輪郭,外形(outline) / 境界線(boundary);限界,限度(limit) / (鉄道・バスなどの)路線;航路,空路 / 《複数形で》せりふ / 進路,道順(course);(考えなどの)筋道,方針 / 《しばしばone's~》(活動の)分野,方面;特意 / 家系,血統,血筋 / 在庫商品,仕入れ品 / 導管,パイプライン / 《しばしば複数形で》戦線,防御線 / …‘に'『線を引く』,筋(しま,しわ)をつける / …‘に'『沿って並ぶ;』(…を)…‘に'沿って並べる《+『名』+『with』+『名』》 
ling	 タラ科の食用魚 
link	 (鎖の)『輪』,環 / 鎖のようにつながったソーセージの一節 / (…と)つなぐ物(人),(…との)きずな,つながり《+『with』(『to』)+『名』》 / 《複数形で》=cuff links / …‘を'『つなぎ合わせる』,連結する;(…と)…‘を'つなぐ《+『名』+『with』(『to』)+『名』》 / (…と)結合する,つながる《+[『up』(『together』)]『with』+『名』》
lint	 リント布(柔らかくした綿布で包帯用) / (ほこりのようになってつく)糸くず
lion	 『ライオン』,しし / (ライオンのように)勇猛な人 / 名士,人気者,花形 / (英国の象徴としての)ライオン;しし紋
lira	 リラ(イタリアの貨幣単位) 
lisp	 舌たらずに発音する(特に[s][z]を発音する) / …‘を'舌たらずに発音する / 舌足らずの発音, プログラミング言語 
list	 (…の)『表』,一覧表,目録,明細書;『名簿』,カタログ《+『of』+『名』》 / …‘を'『表にする』,‘の'一覧表を作る / …‘を'目録(名簿)に載せる;(…として)…‘を'記録する《+『名+as+名(doing』)》 
live	 『生きている』,生命がある / 《副詞[句]を伴って》〈人などが〉『生き続ける』 / 〈物事が〉長く続く,存続する / 《場所を表す副詞[句]を伴って》〈人などが〉『住む』,居住する / 《副詞[句]を伴って》『生活する』,暮らす / 生人を楽しむ,おもしろく桟らす / 《a+形容詞癌lifeを目的語にして》〈…を生活〉‘を'する / 〈思想など〉‘を'実銭する
load	 荷,積み荷,(バス・旅客機などの)乗客数 / 《しばしば複合語を作って》1台(1そう)分(の…)《+『of』+『名』》 / (精神上の)『重荷』,心配 / (個人または機械に割り当てられた)仕事量 / (鉄砲の1回の)装てん(charge) / 《複数形で》《俗》たくさん,多数(の…)《+『of』+『名』》 / (荷・乗客などを)〈車・船など〉‘に'『積む』,載せる《+『名』〈車など〉+『with』+『名』》 / (車・船などに)〈荷など〉‘を'『積む』,載せる《+『名』〈荷〉+『into』(『in,on,onto』)+『名』》 / 〈質問・結果など〉‘を'ねじ曲げる / (フイルム・弾丸などを)〈カメラ・銃など〉‘に'装てんする,入れる《+『名』+『with』+『名』》 / (カメラ・銃などに)〈フイルム・弾丸など〉‘を'装てんする,入れる,込める《+『名』+『into』+『名』》 / 荷を積む / 弾を込める 
loaf	 (一定の形に暑いた)『パンの一塊』 / (ある形にした食品の)『塊』 / 砂糖の円すい形の塊(=sugar loaf) 
loam	 ローム(砂・有機物などを含んだ肥土;れんが・しっくいなどの材料) 
loan	 〈U〉(…の)『貸し付け』《+『of』+『名』》 / 〈C〉貸し付け金,貸与物 / 《『loan』+『名』〈間〉+『名』〈直〉=『loan』+『名』+『to』+『名』》《米》…‘に'…‘を'『貸す』(《英》lend) 
lobe	 耳たぶ / (内臓・組織の)葉(よう)(肺葉・肝葉など)
loch	 湖(lake);入り江 
loci	 locusの複数形 
lock	 錠 / (運河の)水門 / (銃砲の)発射(点火)装置 / (レスリングの)締めわざ / 車輪止め,輪止め / 〈戸など〉に『錠をおろす』(しめる) / (錠をかけたように)〈指・腕など〉‘を'締めつける / 『錠がかかる』 / かみ合う,かみ合って動かなくなる 
lode	 鉱脈 
loft	 屋根裏 / (馬屋の)干し草置き場 / (教会・講堂の)上階 / (クリケット・ゴルフで)〈ボール〉‘を'高く打ち上げる
loge	 (劇場の)仕切席,特別席 
loid	 〈戸〉‘の'ばね錠を薄いセルロイド(プラスチック)片で開ける 
loin	 《複数形で》腰,腰部 / 〈C〉〈U〉腰肉
lone	 《名詞の前にのみ用いて》 / (人が)『孤独の』,ひとりの / (物が)孤立した / ただ一つの
long	 (距離・物の長さが)『長い』 / (時間が)『長い』,長く続く / 《時間・距離などを表離などを表す語を伴って》長さが…の / 『長々しい』,あきあきする / (数量が標準よりも)『多い』,長い / (人が)やせてひょろ長い / 長く,長い間,久しく / …じゅう / ずっと(前に,後に) / 長い間
lope	 〈大きな犬や狼が〉ゆっくりとした足どりで駆ける;〈人が〉大またでゆっくり走る / 大またのゆっくりした駆け足
lord	 〈C〉『主人』,支配者;(封建時代の)『君主』,領主 / 〈U〉《the Lord, our Lord》『主』)しゅ) / 《Lord》《呼びかけや感嘆の表現に用いて》 / 〈C〉『貴族』;《Lords》(英国の)上院議員たち / 〈U〉《Lord》…卿(きょう)(英国の貴族および高位の官職の尊称) 
lore	 (民族の間に伝承された特殊な)民間伝承,民族伝承 / (特定の題目に関する)知識,学問
lorn	 孤独の,わびしい, 見捨てられた 
lose	 〈物〉‘を'『失う』,なくす,〈人・道など〉‘を'見失う,〈仕事・権利・命など》‘を'失う / 《『lose』+『名』+『名』》〈物事が〉〈人〉‘に'…‘を'失わさせる / 〈勝負事・訴訟・戦争など〉‘に'『負ける』 / …‘を'『保つことができなくなる』 / …‘を'免れる,脱する / …‘を'『逃す』,むだにする / 〈時計が〉〈ある時間〉‘だけ'『遅れる』 / (…で)損をする,(…を)失う《+『in』(『on』)+『名』》 / (試合・ゲームなどで)負ける《+『in』+『名』》 / 〈時計が〉遅れる
lost	 loseの過去・渦去分詞 / 『失った』,なくなった,紛失した / 『負けた』;(賞などを)取りそこなった / (時間・労力などが)『浪費された』・破壊された(destroyed) / 《補語にのみ用いて》(…に)夢中になった,没頭した《+『in』+『名』》 
loth	 =loath 
loud	 (音・声が)『大きい』,大きな音を出す / 『騒々しい』;はでな,人目を引く / 『大声で』,声高に 
lour	 =lower
lout	 ぶこつ者,田舎者 
love	 〈U〉(…に対する)『愛』,愛情《+『for』(『of,to,toward』)+『名』》 / 〈U〉《時にa~》(物事に対する)『強い好み』,愛好《+『of』(『for』)+『名』》 / 〈U〉恋愛 / 〈C〉《my~》愛人,恋人 / 《夫・妻子・愛人に呼びかけて》おまえ,あなた / 〈C〉愛好するもの / 〈C〉(テニスで)零点 / …を愛する / 〈物事〉‘が'『大好きである』 / …‘に'『恋する』,ほれる / 愛する;恋する 
lube	 潤滑油[を塗ること] 
luck	 『運』,巡り合わせ / 『幸運』
ludo	 さいころ遊びの一種 
lump	 (一定の形のない)『塊』 / 小さい立方体 / 『こぶ』,はれもの / 《話》のろま,まぬけ,でくのぼう / 《英話》《集合的に》飯場臨時作業員 / 塊になった / 一まとめの,一括した / 〈いくつかのもの〉‘を'一まとめにする,一様に扱う《+『together』+『名,』+『名』+『together』》 / 塊になる 
lung	 《しばしば複数形で》『肺』,肺臓 
lure	 『誘惑するもの』,魅力 / 《おもに英》(魚釣り用の)にせ餌(え);(他の鳥をおびき寄せるための)おとり / ‘を'『誘惑する』,おびき寄せる《+『名』+『on』》 
lurk	 (…に)〈人・動物が〉『潜む』,潜状する;(…に)〈感情などが〉潜在する《+『in』+『名』》 / (…を)こそこそ歩く,潜行する《+『about』+『名』》
lush	 (草木が)生い茂った,青草の多い / 《話》豊富な,ぜいたくな
lust	 (…に対する)『強い欲望』,渇望《+『for』(『of』)+『名』》 / 色欲,肉欲 / (…を)切望する,渇望する《+『after』(『for』)+『名』》 
lute	 リュート(17世紀ごろまで用いられたギターに似た弦楽器) 
lynx	 オオヤマネコ(ヤマネコの一種;目が鋭く耳の先に房状の毛がある) 
lyre	 リラ(古代ギリシアのたて琴;歌などの伴奏用) 
mace	 戦棍(せんこん),鎚(つち)ほこ(中世の武器) / 職杖(しょくじょう)(市長・大学総長などの職の象徴としての杖(つえ))
made	 makeの過去,過去分詞 / 成功確実な / 《複合語を作って》「…製の」「構成が…の」「…の体つきの」の意を表す / 《補語にのみ用いて》《『be made for+名』》(…に)うってつけである
magi	 《話》=magazine 
maid	 《文》《古》『少女』,おとめ;処女 / 『未婚の女性』 / 『お伝いさん』女中 
mail	 鎖かたびら,よろい / …‘に'鎖かたびらを着せる,武装させる
main	 《名詞の前にのみ用いて》『おもな,主要な』 / 〈C〉《通例複数形で》(水道・ガスなどの)本管;主電線;(鉄道の)本線,幹線 / 〈U〉《the~》《詩》大海,大海原(おおうなばら) 
make	 …‘を'『作る』,製造する,建造する / …‘を'『整える』,用意する / …‘を'生じさせる,もたらす,引き起こす / 〈金など〉‘を'得る,もうける,〈財産など〉‘を'作る / 《行為・動作を表す名詞を目的語にして》…‘を'『する』,行う / (ある状態・形態に)…‘を'『する』 / 《『make』+『名』+do》〈人・動物など〉‘に'強制して(…)させる / …‘を'判断する,解釈する,思う / …‘を'構成する,(計算・合計が)…‘に'なる / …‘に'『なる』,‘と'なる,‘の'資格(素質)がある / 《話》〈ある距離〉‘を'行く,〈ある速さ〉‘で'進む / 〈目的地など〉‘に'到着する,着く / 〈会社・集会など〉‘に'間に合う;《話》〈乗物〉‘に'間に合う / 〈人・企画〉‘を'成功させる,‘の'成功(幸運,出世)を確実にする / 《話》…‘の'一員になる / (ある状態・形態に)なる,ふるまう / (…の方へ)進む,向かう《+『for』(『to, toward』)+『名』) / 《まれ》《副詞[句]の伴って》作られる,できる / 《まれ》《副詞を伴って》〈かさなどが〉増す,〈雪が〉積もる / 作り,型;製造;種類,銘柄 / 性格,気質;体つき 
male	 『男性の』,男の;(動物が)雄の,(植物が)雄性の / 《名詞の前にのみ用いて》(機械・器具などが)雄の差し込み口のある / 『男性』;(動物の)雄,雄性植物 
malt	 麦芽,麦もやし / (また『malt liquor』)麦芽酒(麦芽から作ったビール・エールなど) / 〈C〉=malted milk 2 / 〈麦〉‘を'麦芽にする;〈酒など〉‘を'麦芽で作る / 〈麦が〉麦芽になる 
mane	 (馬などの)たてがみ 
many	 『多くの』,『たくさんの』,多数の / 《many a(an)…の形で》《文》《単数名詞を従えて》多くの,多数の / 《複数扱い》 / (…の)『多数』《+『of』+『名』(複数形)》;多数の人(もの) / 《the~》『大多数』,大衆 
marc	 マーク(ぶどうやりんごのしぼりかすで作ったブランデー) 
mare	 雌ウマ 
mark	 〈C〉(…の表面についた)『跡』,汚れ,はん点《+『on』+『名』》 / 〈C〉『印』,記号,符号,標章 / 〈C〉《おもに英》(学業などの)『点数』,成績,評価,(…の)得点《+『in』(『for』)+『名』》 / 〈C〉(ある性質の)『徴候』,『特徴』,現れ,様相《+『of』+『名』》 / 〈C〉(思想・生活などに及ぼす)『影響』,感化《+『on』+『名』》 / 〈C〉(境界などの)位置を示すもの,指標,目印 / 〈C〉『的』,標的 / 〈C〉《the mark》水準,標準 / 〈U〉《文》著名,重要性;名声 / 〈C〉(軽べつ・もの笑いなどの)対象,的 / 〈U〉《通例M-》武器記号,…型 / 〈C〉スタートライン / (…で)…‘に'『印をつける』,跡をつける《+『名』++『with』+『名』》 / 〈物が〉…‘を'印となっている,‘を'示している / …‘を'印(記号など)で示す / 〈物・事柄などが〉…‘を'『特徴づける』,目立たせる / 〈答案など〉‘に'点(印)をつける / (…の候補に)…‘を'選び出す《+『名』+『out for』+『名』》 / …‘に'注意を払う,柱目する 
marl	 泥灰土(粘土と炭酸カルシウムから成り肥料やセメントの原料になる) 
mart	 市場,店;商業中心地 
mash	 もやし汁(ビールの原料) / ふすま(ひき割りなど)を湯で溶かした家蓄の飼料 / どろどろにすりつぶしたもの / (調理などで)…‘を'すりつぶす
mask	 (顔の一部または全部をおおう)『仮面』,覆面 / (防護用の)『マスク』,面 / (石膏(せっこう)などの)面型 / (物・事柄を)覆い隠すもの;見せかけ / 〈顔〉‘に'面をかぶせる / (…から)〈物・事柄など〉‘を'隠す《+『名』+『from』+『名』》
mast	 『マスト』,帆柱 / (装飾用の)高い柱;(無電用・起重機用の)鉄塔
mate	 (対をなすものの)『片方』《+『to』(『of』)+『名』》 / 『配偶者』[の一方],連れ合い / (動物の)つがいの片方 / 《英》《しばしば複合語を作って》『仲間』,『友達』 / (商船の船長を補佐する各階級の)航海士 / …の助手 / 〈動物〉‘を'つがわせる / 〈二つのもの〉‘を'結ぶ;(…に)…‘を'調和させる《+『名』+『with』+『名』》 / 〈人・動物が〉(…と)仲間になる,交わる《+『with』+『名』》 / 〈動物が〉交尾する
math	 《米話》=mathematics1(《英話》maths) 
maul	 (くいなどを打ち込む)大づち,かけや / …‘を'打って傷つける / …‘を'手荒に扱う 
maxi	 《話》マキシ(すそが足首まである服・スカート) 
mayo	 マヨネーズ[mayonnaiseの短縮形] 
maze	 迷路 / 混乱,当惑,混迷
mazy	 迷路のような 
mead	 =meadow 
meal	 (一定の時刻に定められた)『食事』;食事の時間 / (1回分の)食事,(食事1回分の)食べ物
mean	 〈人が〉…‘を'『意図する』,‘の'つもりである;…‘を'言おうとある;示そうとする / 〈単語・句・文章などが〉…‘を'『意味を持つ』,‘を'『意味する』 / (人に対して)…‘を'当てる,向ける《+『名』+『for』+『名』》 / 《受動態で》〈人・物〉‘を'(…)向きにする / 〈物事が〉…‘を'示す,表す / (結果として)〈物事が〉…‘を'もたらす,生じさせる / 《『mean』+『for』+『名』+『to』 do》《米話》(…が…するような)つもりでいる 
meat	 (食用の)『動物の肉』 / 《英古》《米文》(一般的に)『食物』(food) / (課実などの)食用部分,果肉 / (議論・書物などの)最も重要な部分,主眼点,骨子《+『of』+『名』》
meld	 (カードゲームで)〈ある組み合せのカード〉‘を'見せて得点を宣言する / 得点宣言をする / 得点になる組合せ 
melt	 (熱・水などによって)『溶ける』,溶解する / 〈人・心気持ちなどが〉『しだいに和らぐ』 / 〈色・音などが〉(…に)しだいに変わっていく《+『into』+『名』》 / 溶けてしだいに小さくなる(少なくなる,消えていく)《+『away』》 / (熱・水などによって)(…に)〈物〉‘を'『溶かす』,溶解する《+『名』+『in』+『名』》 / 〈心・気持ちなど〉‘を'しだいに和らげる / …‘を'しだいに無くする 
mend	 …‘を'『直す』,修繕いる / 〈行い・誤りなど〉‘を'『改める』,改善する / (繕って)元通りになる / 〈病人・けがなどが〉快方に向かう / 修繕箇所 / かがった部分
menu	 (レストランの)『メニュー』,献立表 / 料理
meow	 ニャー(猫の鳴き声) / 〈猫が〉ニャーと鳴く[擬声語]
mesa	 メサ(米国南西部に多い台地で,頂上は平らで周囲は絶壁の地形) 
mesh	 〈C〉《単数形で》(網・ふるいなどの)目,網目 / 〈C〉〈U〉網,網細工 / 〈C〉〈U〉網目状の織物(編物),メッシュ / 〈C〉《複数形で》網の目をかがった糸 / 〈C〉わな / 〈歯車・歯などが〉(…と)かみ合う《+『with』+『名』》 / 《性質・考え方などが》ぴったり合う / 〈魚など〉‘を'網で捕らえる
mewl	 (赤ん坊が泣くように)弱弱しく泣く / 弱々しい泣き声
mica	 雲母(うんも),きらら 
mice	 mouseの複数形 
mick	 《俗》《軽べつして》アイルランド人 
mien	 (人柄・感情が分かるような)態度,物腰,様子 
mike	 =microphone 
mild	 (人,人の気性・態度などが)『柔和な』,ものやわらかな,温和な / (程度・力・効果などが)『適度な』,ほどよい / (病気などが)そんなにひどくない,軽い / (気温が)おだやかな / (味・においが)強くない,ぴりぴりしない 
mile	 〈C〉『マイル』(長さの単位;1609メートル) / 《the ~》1マイル競走(mile race) / 〈C〉《複数形で》《話》長い距離;多量,たくさん 
milk	 (雌の哺乳(ほにゅう)動物が分泌する)乳,(特に食料としての)『牛乳』,『ミルク』 / (植物の)乳汁,乳剤,乳液 / 〈牛など〉‘の'乳をしぼる / 〈情報など〉‘を'引き出す;(…を)〈人〉‘から'しぼり取る《+『名』+『of』+『名』》 / (毒を)〈蛇〉‘から'抜き取る《+『名』+『of』+『名』》 / 〈牛などが〉乳を出す
milt	 (雄魚の)魚精,白子 
mind	 〈U〉(思考・知覚・意志などをつかさどる)『心』,精神 / 〈C〉《単数形で》(心の働きによって生じた)『知性』,理性,理解力 / 〈U〉正常な精神状態,正気 / 〈C〉意見,考え方,物の見方 / 〈U〉記憶,回想 / 《one's~》注意,精神の集中 / 〈C〉《単数形で》願い,意向 / 〈C〉《前に形容詞を伴って》(…を備えた)人 / 《しばしば命令文で》…‘に'『注意する』,用心する / …‘の'番をする,世話をする(look after) / 〈人,助言など〉‘の'言うことを聞く,‘に'従う / 《否定・疑問・条件文で》…‘を'『気にする』,『気にかける』,いやだと思う / 《疑問文・否定文で》気にする,心配する,いやに思う 
mine	 『私のもの』 / 《of mineの形で》『私の』 / 《古》私の(my)《母音または綴字がhで始まる語の前,あるいは名詞の後に用いて》 
mink	 〈C〉ミンク(イタチに似た動物) / 〈U〉ミンクの毛皮(光沢のある茶色で,高価) / ミンクの 
mint	 〈U〉ハッカ / 〈C〉ハッカ入りのキャンデー(ガム)
minx	 おきゃん,おてんば娘,生意気な娘 
mire	 《文》湿地,沼地(bog) / ぬかるみ,深い泥(どろ) / 〈車・馬など〉‘を'沼地(ぬかるみ)にはまらせる / 〈車など〉‘を'泥で汚す / 〈車などが〉沼地(ぬかるみ)にはまる 
miry	 泥だらけの;泥沼の 
mist	 〈C〉〈U〉『かすみ』,もや,霧 / 〈U〉(窓ガラスなどで水蒸気による)曇り;霧(もや)状(の…)《+『of』+『名』》 / 〈C〉《the ~》(涙などによる)目のかすみ《+『of』+『名』》 / 〈C〉《a ~》(疲労などによる)心の曇り,判断の鈍り《+『of』+『名』》 / 《the mists》《文》(過去の)もやに包まれた時代《+『of』+『名』》 / 霧(もや)が掛かる;(涙などで)〈目などが〉曇る《+『over』(『up』)+『名』》 / 《米》《itを主語にして》霧雨(きりさめ)が降る(drizzle) / …‘を'かすみ(もや)で覆う;…‘を'曇らせる《+『up』+『名』》
mite	 ダニ(動植物や貯蔵品などに寄生する虫) 
moan	 〈C〉(悲しみ・苦痛などの)『うめき[声]』《+『of』+『名』》 / 〈U〉《時にa ~》(風・波などの)うめき声に似た音,うなり《『of』+『名』》 / 『うめく』,うめき声をあげる / 〈風・波などが〉うめくような音をてたる,うなる / …‘を'うめくように言う(歌う)《+『out』+『名』,『名』+『out』》 
moat	 (城壁・とりで・都市の回りの)堀(ほり) / …‘に'堀を巡らす
mock	 〈人,人の言動〉‘を'『あざける』,ばかにする / 〈人の言動〉‘を'『ふざけてまねる』 / 〈努力・力など〉‘を'無視する,無にする / (…を)あざける,ばかにする(scoff)《+『at』+『名』》 / 《名詞の前にのみ用いて》にせの,ごまかしの / あざけり
mode	 〈C〉(…の)『方法』,やり方,流儀《+『of』+『名』(do『ing』)》 / 〈U〉〈C〉(服装などの)『流行』,モード / 〈C〉(動詞の)法,叙法(mood) / 音階(scale)
moil	 あくせく働く 
moke	 （英俗）ろば(donkey) 
mole	 モグラ 
monk	 (一般に)修道僧,僧侶(そうりょ);(キリスト教の)修道士,道士 
mope	 ふさぎ込む,意気消沈する / 〈C〉ふさぎ込んだ人 / 《the mopes》意気消沈,憂うつ 
more	 (数・量・程度などが)(…より)『いっそう大きい』,『もっと多く』,ずっと高い《+『than…』》 / 《しばしば数詞,any,some,no,a,few,a littleなどを伴って》『それ以上の』,『もっと多くの』 / 《単数扱い》(…より)『もっと多く』[『の数』,『量』,『程度』];それ以上[の数,量,程度]《+『than…』》 / 《複数扱い》(…よりも)『もっと』(『さらに』)『多数の人』(『物』)《+『than…』》 / (…より)『さらに多く』,もっと《+『than…』》 / 《形容詞・副詞の比較級を作って》(…より)『もっと』,いっそう《+『than…』》 / 『その上さらに』, / 《『more…than ~』》~『よりはむしろ』…
morn	 朝,暁(morning) 
most	 《the ~》(数・量・程度などが)『最も多い』,最高の,最大の / 《theをつけないで》『たいていの』,大概の / 《the ~》《単数扱い》『最大数』(量),最高額,最大限度 / 《theをつけないで》(…の)『大部分』,大多数《+『of』+『名』》 / 『最も多く』,いちばん / 《形容詞・副詞の最上級を作って》『最も』 / 《theをつけないで》はなはだ,非常に / 《米話》ほとんど(almost, nearly)
mote	 ちり,(特に,ほこりの)小片 
moth	 『ガ』(蛾);(衣類などを食い破る)イガ 
move	 《しばしば副詞[句]を伴って》『動く』,移動する,揺れ動く / (…から…へ)『引っ越す』,移転する《+『from』(『out of』)+『名』+『to』+『名』》 / 《副詞[句]を伴って》〈時間などか〉経過する(ある方向へ)〈事態・仕事などが〉進展する,向かう / (…で)活動する,活躍する《+『in』(『on』)+『名』》 / 動議を出す,提案する / (チェス・チェッカーなどで)こまを動かす / 《しばしば副詞[句]を伴って》…‘を'『動かす』,移動する,進行させる;…‘を'揺り動かす / 《しばしば受動態で》〈人〉‘を'『感動させる』,‘の'気持ちを動かす / …‘を'動議する,提案する / 措置,手段 / (チェス・チェッカーなどで)こまを動かすこと,一手;こまを動かす番,手番 / 《単数形で》動き,動作
mown	 mowの過去分詞 
msec	 millisecond; millisecondsミリセカンド(1秒の1000分の1) 
much	 (量・程度などが)『多くの』,多量の / 『たくさん』,多量 / 《通例否定文の補語として》大した物(事),重要な物(事) / 《動詞・過去分詞を強めて》『大いに』,非常に / 《形容詞・副詞の比較級・最上級を強めて》『ずっと』,はるかに / 《「同じ」の意味の語句を修飾して》たいてい,ほとんど
muck	 牛馬ふな;下肥(しもごえ),こやし / ごみちり;汚物 / 黒腐土 
mule	 ラバ(雄のロバと雌の馬との雑種;生殖力がない) / 《話》強情な人・ミュール精紡機; (形容詞)) 雑種の
murk	 暗黒;陰うつ 
muse	 (…について)『深く考える』,瞑想(めいそう)する(meditate)《+『on』(『upon, over』) +『名』(do『ing』)》 
mush	 濃いとうもろこしがゆ / どろどろしたもの / 《話》安っぽい感傷 
musk	 じゃ香;じゃ香の香り 
must	 《義務・必要》…『ねばならない』,すべきである / 《命令・強制》…『ねばならない』,…せよ;《否定文では禁止》…『してはいけない』 / …『にちがいない』,きっと…のはずだ;《「must have+過去分詞」の形で》…であったに違いない,きっと…であったはずだ / 『必ず…する』,…は避けられない / どうしても…しないと承知しない / 《話》《過去のあいにくのでき事》あいにく…した / 《話》絶対必要なもの,欠かせないもの,必ず見る(聞く,読む)べきもの / 《名詞の前にのみ用いて》絶対必要な,不可欠の
mute	 (障害で)『口のきけない』,ものを言えない / 『無言の』,声(音)を出さない / (文字が)発音されない,黙字の / 口のきけない人(dumb person) / (楽器に付ける)弱音機,ミュート / …‘の'音を消す(弱める),〈楽器〉‘に'弱音機を付ける;〈声・音〉‘を'弱める
myna	 九官鳥(アジア産のムクドリ科の鳥) 
myth	 〈C〉(個々の)『神話』,神代物語;〈U〉《集合的に》神話 / 〈C〉神話的な人(物・事) / 〈C〉作り話,伝説;(…という)作り話《+『that節』》 
naif	 =naive 
nail	 (手の)『つめ』(fingernail);《まれ》(足の)つめ(toe-nail);(鳥獣の)つめ(claw, talon) / 『くぎ』,びょう / (…に)…‘を'くぎ(びょう)で止める《+『名』+『on』(『to』)+『名』》 / (…に)〈人,人の注意・目など〉‘を'くぎ付けにする《+『名』+『on』(『to』)+名》 / 《話》…‘を'つかまえる,しとめる;〈うそなど〉‘を'見破る 
name	 『名』,『名前』,姓名;(物の)名称;名義 / 《単数形で》『名声』;評判(reputation) / 悪口,悪態 / 《俗》有名な人 / 名のある,有名な,一流銘柄の / …‘に'『名をつける』,命名する / ‘を'『名を言う』 / 〈人〉‘を'指名する,任命する / (…に対して)…‘を'指定する《+『名』+『for』+『名』》 
nape	 うなじ,えり首 
narc	 麻薬取締官 
nard	 甘松(かんしょう)香(古代人が用いた香油) 
nark	 =narc 
natl	 national 
nave	 (教会の)身廊(しんろう),会衆席 
navy	 《集合的に;《米》単数扱い,《英》単数・複数扱い》『海軍』 / 《集合的に;《米》単数扱い,《英》単数・複数扱い》《通例the N-》(ある国の)海軍 / 〈U〉=navy blue 
neap	 小潮(こしお)(潮の干満の差が最小の日) 
near	 (空間的・時間的に)(…の)『近くに』,(…に)接近して《+『to』+『名』》 / 《しばしば複合語を作って》『ほとんど』(almost, nearly) / (空間的・時間的に)『近い』,接近した / (関係などが)『身近な』 / 『きわどい』,やっとの / (空間的・時間的に)…『に近く』,『の近くに』 / (状態などが)…に近く,…しそうで / (時間・空間上)…‘に'近づく / 近づく,接近する 
neat	 (見た目に)『きちんと整った』,小ぎれいな / (人などが)きれい好きな;(服装などが)さっぱりした / (やり方・話し方などが)手ぎわのよい / 《米話;現在はまれ》すばらしい,すてきな / 《話》(酒などが)水で割らない,ストレートの 
neck	 〈C〉(人間・動物の)『首』;首の骨 / 〈C〉(衣服の)えり / 〈C〉首の形をした物 / 〈U〉〈C〉(食品としての)(羊などの)頚肉(けいにく) / キスして愛撫(あいぶ)し合う 
nest	 (鳥・昆虫・魚類・小動物などの)『巣』,巣穴 / 《集合的に》巣の中の鳥(動物など),(昆虫などの)群れ / 居ごこちよい場所,落ちつける場所 / (犯罪などの)温床;(悪党などの)巣窟(そうくつ) / (入れ子式・重箱式などになった物の)一組,一そろい《+『of』+『名』》 / 巣を作る,巣ごもる / …‘を'巣に入れる / (巣に入れるように)…‘を'すっぽり収める / …‘を'入れ子式にする,重ね合わせる 
news	 (新しい)『報道』,記事;(一般的に)知らせ,たより) / (耳新しい)『事件』,でき事 / 《N-》(新聞名として)…新聞 
newt	 イモリ 
next	 (時間・順序が)『次の』,すぐ後に続く;来…,翌… / (場所・位置が)『いちばん近い』,隣の / (時間・順序などの点で)『次に』,今度は / 次の人,次のもの
nibs	 親分,大将,ボス 
nice	 (物事が)『良い,気持ちよい』(pleasant) / (人が)『親切な』,思いやりのある / 『十分満足のできる』,すばらしい,質のいい / 微妙な,デリケートな;精密な,正確な / 育ちのいい,礼儀正しい;洗練された 
nick	 刻み目(notch) / 表面だけの切り傷,かすり傷 / …‘に'刻み目(傷)をつける・「in the nick of time」で「きわどい時に, ちょうどよく」 
nigh	 近くの(near) / 近くに(で) / ほとんど / …の近く(そば)に
node	 (茎・幹の)節(ふし) / (体組織にできた)結節,こぶ(リンパ瘤(りゅう)など) / (天体の軌道の)交点 / (物事の)中心点
nope	 いいや,いえ(no) 
norm	 《しばしば複数形で》標準,規準;一般水準;(行動の)規範,ノルマ・基準量(値)
nose	 『鼻』 / 《単数形で》(…に対する)『嗅覚』(きゅうかく)《+『for』+『名』》 / (鼻のように)突起した部分;船首,機首 / 《単数形で》(…を)かぎつける力《+『for』+『名』》 / 《副詞[句]を伴って》…‘を'鼻で押す,鼻でさわる(こする) / …‘を'鼻でかぐ,‘を'においをかぐ;…‘を'においで知る / (…の)においをかぐ《+『at』+『名』》 / 《副詞[句]を伴って》(用心しながら)鼻先を向けて進む
nosh	 間食をする,つまみ食いする / 《おもに英俗》食べる / 〈U〉食べ物 / 〈C〉《単数形で》食べること
note	 〈C〉《複数形で》『覚え書き』,控え,メモ / 〈C〉(本文に対する)『注』,駐釈 / 〈C〉(形式ばらない)『短い手紙』,短信;外交上の文書 / 〈U〉『注目』,注意 / 〈U〉『重要性』(importance);顕著 / 〈C〉《単数形で》(声の)調子,(感情などの)しるし,兆候《+『of』+『名』》 / =promissory note / 〈C〉『紙幣』 / 〈C〉音楽;音符;(ピアノなどの)けん / …‘を'『書き留める』,記す / …‘に'『注意する』;…Iと'気づく / (取り立てて)…‘に'ついて言う,‘を'習す
nous	 常識,心,精神,知性,知恵 
nova	 新星(突然明るくなり,また元に戻る星) 
nude	 裸の,裸体の / 〈C〉(美術作品の)裸体画,裸像,ヌード / 〈C〉裸体の人 / 《the ~》裸の状態
nuke	核兵器 / 原子力発電所 / …‘を'核兵器で攻撃する・（おどけて）食品を電子レンジで調理する・核爆弾、核兵器、原子核、原子力、原子力潜水艦、原子力発電所
numb	 麻痺(まひ)した,感覚を失った,しびれた / …‘の'感覚を失わせる,‘を'しびれさせる
nuts	 気違いの;気違いじみた / (…に)夢中の《+『about』(『over』)+『名』》 / (失望・不幸・拒否・失敗などを示して)ちぇっ,だめだ,くそっ 
oath	 〈C〉〈U〉『誓い』,誓約 / 〈C〉のろいの言葉,悪態;下品な言葉
obey	 〈人〉‘に'『服従する』 / 〈命令・法律など〉‘に'『従う』,‘を'守る / …‘に'従って動く / 服従する;命令に従う
obit	 =obituary 
ogle	 …‘に'色目をつかえ,秋波を送る / (…に)秋波を送る《+『at』+『名』》 / 〈C〉《単数形で》色目,秋波 
ogre	 (童話・伝説などに出てくる)人食い鬼 / 酸酷な人,野蛮な人
oily	 油の;油のような / 油をひいた,油っぽい,油まみれの / (話し方・態度などが)いやに巧みな,おじょうずな 
oink	 豚の泣き声 / 〈豚が〉ブーブー泣く
okay	 =OK,O.K. 
okra	 オクラ(アオイ科の植物;粘りけのあるさやを食用にする) / (またgumbo)《集合的に》オクラのさや
oldy	 =oldie 
omen	 前兆,きざし 
omit	 (…から)…‘を'『省略する』,省く《+『名』+『from』+『名』》 
once	 (ただ)『1度』,『1回』 / 『かつて』,以前 / 《否定文で》一度も(…しない);《条件節で》いったん…すれば / 『1度』,1回 / 『いったん』…『すれば』,…するとすぐに 
only	 『唯一の』,たった一つ(一人)の;《複数名詞に付けて》ただ…だけ / 『最適の』,最良の(best) / 《数量に関して》『たった』,わずか / 『ただ…だけ』(『ばかり』),単に…に過ぎない / ただし,だが / 《英》《thatを伴って》…ということさえなければ
onus	 (…の)重荷,負担,責任,義務《+『of』+『名』(do『ing』)》 / 非難
onyx	 シマメノウ 
opal	 オパール,蛋白石(乳白色でにじ色に変化する光をもつ宝石) 
open	 …‘を'『開く』,開ける;…‘の'ふた(おおい)をとる / …‘を'『切り開いて作る』,開拓する;…‘を'全開通させる《+『名』+『up,』+『名』+『up』》 / …‘を'『広げる』《+『up』+(『out』)+『名,』+『名』+『up』(『out』)》 / …‘を'『始める』 / …‘を'開業する,開店する,開場する / (人に)〈心など〉‘を'打ち明ける,〈秘密など〉‘を'漏らす《+『名』+『to』+『名』》 / (新思想などに)〈心・目〉‘を'開く《+『名』+『to』+『名』》 / 〈戸などが〉『開く』,あく / 〈花・つぼみが〉開く《+『out』》 / 〈学校などが〉『始まる』;〈店などが〉開く / 〈道路などが〉開通する / (…に)向かって開いている,(…に)通じている《+『out』『on』(『upon,to,onto』)+『名』》 / 《副詞[句]を伴って》〈風景などが〉広がる,ひらける / 本を開く;(…)ページを開く《+『to』(《英》『at』)+『名』》 / (窓・口などが)『開いた』,開いている;(包みなどが)広げられて / (花が)咲いた / (店などが)『開いている』,開業している;(催し物が)『公開の』,だれでも入れる / 《名詞の前にのみ用いて》ふたのしてない,屋根のない,おおいのない / 広く開いた,さえぎるものがない / 公然の / 率直な,遠慮しない / さらされている,無防備の / 《補語にのみ用いて》(職・地位などが)空位の;(時間などが)あいている / (問題・議事などが)未解決の / 凍結しない,雪や霜の降らない;温和な / (漁・猟が)解禁の / (音声が)開口音の;開音節の / 《the~》戸外,野外 / 空き地;(樹木のない)開けた場所,平野 
opus	 (音楽の)作品 
oral	 『口頭の』,口述の(spoken) / 口の,口部の / 経口の 
orgy	 〈C〉乱交パーティー / 〈C〉どんちゃん騒ぎ / 《複数形で》(古代ギリシア・ローマの)酒神Dionysus(Bacchus)の秘密祭 
oryx	 オリックス(アフリカ産の大カモシカの種) 
ouch	 (突然の痛さに叫んで)痛い 
ours	 『私たちのもの』,『我々のもの』 / 《…of oursの形で》私たちの,我々の
oust	 (場所・地位などから)…‘を'追い払う,追い出す《+『名』+『from』+『名』》 
oval	 卵形の / 長円形の / 〈C〉卵形(長円形)のもの 
oven	 天火,かまど,オーブン 
over	 《上方の位置・場所》…『の上に』,を覆って;…に覆いかぶさって / 《移動を指す動詞とともに用いて》…『を越えて』 / 《状態を表す助詞とともに用いて》…を越えた向こうに / 《数詞を伴って》…『以上に』 / …『の一面に』,の至るところに / …『支配して』,より勝って / …『について』,に関して / …『しながら』に従事して / 《期間》…『の間ずっと』 / (電話・ラジオなど)『で』,によって / …に沿って,…を(along) / 『越えて』,渡って,向こうへ / 倒れて,ひっくり返って / 『終わって』,すんで / ひっくり返して / 『繰り返して』 / 『あふれて』;余って / 『終りまで』,ずっと,すっかり / 過度に / (クリケットで)乗判が交替を命じるまでの投球数
ovum	 卵,卵子 
oxen	 oxの複数形 
oyez	 聞け,静粛に(Hear ye!)(開廷の際,廷吏が通例3回叫ぶ) 
pace	 〈C〉『1歩』;歩幅(ほぼ75‐100cm) / 〈C〉〈U〉『歩調』,速度,ペース / 〈C〉《単数形で》(馬の)側対歩(同じ側の前後の脚を同時に上げ下げする歩き方) / …‘を'一定の歩調で歩き回る / …‘を'歩いて測る,歩測する《+『off』(『out』)+『名,』+『名』+『off』(『out』)》 / …‘の'速度を調整する / 《副詞[句]を伴って》ゆっくり(普通の速さで)歩く,ゆっくりと行ったり来たりする / 〈馬が〉側対歩で歩く
pack	 『包み』,『束』;荷物 / (…の一つの)『包み』,組,そろい《+『of』+『名』》 / (人・動物などの一つの)『隊』,群れ《+『of』+『塁』》 / 《a~》たくさん(の…)《+『of』+『名』》 / (傷口などに当てる)湿布 / (美容のための)パック / 〈物など〉‘を'『包む』,『束ねる』,荷作りする / (物)〈容器など〉‘に'『詰める』,入れる《+『名』+『with』+『名』》 / (容器に)〈物など〉‘を'『詰め込む』,いっぱいに入れる《+『名』+『into』(『in』)+『名』》 / 《しばしば受動態で》(人・物が)〈城所・乗り物など〉‘を'『いっぱいにする』 / 《米話》…‘を'身につけている / (運搬・保管などのために)『荷作りする』,『包装する』《+『up』》 / 〈物が〉荷作りできる,包装し得る / (…に)〈が〉ぎっしりはいる《+『into』+『名』》
pact	 協定(agreement),条約(treaty) 
page	 (本・手紙・新聞などの)『ページ』 / (新聞などの)欄,記事 / 《文》注目すべき事件(時期) / …‘に'ページを付ける
paid	 payの過去・過去分詞 
pail	 『手おけ』,バケツ(bucket) / (…の)手おけ1杯分《+『of』+『名』》
pain	 〈C〉〈U〉(肉体のある部分の)『苦痛』,『痛み』 / 〈U〉(精神的な)『苦痛』,心痛 / 《複数形で》骨折り,苦労,努力 / 〈C〉不快感,いやな感じ;うんざりさせるもの,やっかい者 / (肉体的・精神的に)…‘に'苦痛を与える(受動態にできない) 
pair	 (二つで一つに用いられる物の)『組』,『対』《+『of』+『名』》 / (対になる部分からなる物の)『1個』《+『of』+『名』》 / 《集合的に》《複数扱い》夫婦,婚約中の男女;(動物の)つがい《+『of』+『名』》 / 《集合的に》《複数扱い》(同種または何かの関係のある物の)二人(二つ,2頭など)の組《+『of』+『名』》 / …‘を'二人(2個)ずつ組にする《+『名』+『off』(『up』),+『off』(『up』)+『名』》,(…と)…‘を'組にする《+『名』+『with』+『名』》 / (…と)…‘を'結婚させる《+『名』+[『up』]『with』+『名』》 / 二人(2個)ずつ組になる《+『off』(『up』)》 
pale	 (顔が)『青白い』,生色がない,青ざめた / (色が)『薄い』,淡い,白色に近い / 光が弱い,薄暗い,ぼんやりした / 〈人が〉『青ざめる』;〈色・光が〉薄くなる,淡くなる / 〈人〉‘を'青白くする;〈色・光〉‘を'薄く(淡く)する 
palm	 (人動物の)『手のひら』;(手袋の)手のひらの部分 / パーム(手のひらの幅を基準にした長さ;8‐10`) / …‘を'手で殖れる,手の中に隠す 
pane	 (1枚の)『窓ガラス』 
pang	 (突然の)『激痛』,差しこみ / 心痛,痛根,激情
pant	 『あえぐ』,息を切らす / 《現在分詞の形で》熱望する,強く望む / …‘を'あえぎながら言う《+『out』(『forth』)+『名,』+『名』+『out』(『forth』)》 / 『あえぎ』,息切れ;動悸(どうき)
pard	 仲間,相棒(partner) 
pare	 (通例刃物で)…‘の'皮をむく(peel) / 〈不ぞろいな部分など〉‘を'切り取る,削る(《+『away』(off』)+『名』+『away』(『off』)》 / (削るようにして)〈予算など〉‘を'減らす,切詰める《+『down』+『名,』+『名』+『down』》 
park	 (町の中の)『公園』,庭園 / 自然公園 / 《米》(観覧席などで囲まれた)競技場;《英》サッカー場 / 《英》(貴族や大地主の邸宅の)広大な敷地,大庭園 / =parking lot / 〈車〉‘を'『駐車する』 / 《話》(ある時間)〈物〉‘を'置く,預ける / 『駐車する』
part	 〈C〉(全体を構成する)『部分』 / 〈U〉《しばしばa~》(…の)『一部』,『一部分』《+『of』+『名』》 / 〈C〉《割合》…分の1,(比率の)1 / 〈C〉(機械,器具などの)部品 / 〈C〉(仕事などの)『役目』,分担;関与 / 〈U〉(対立・契約などの)一方の側 / 〈C〉《おもに米》(頭髪の)分け目(《おもに英》parting) / 〈C〉《複数形で》地域,地方 / 〈C〉(演劇・影画・オペラなどの)『役』,役割り(role);(役の)せりふ / 〈C〉声部,音部,パート;パート譜 / (複数形で)才能,資質 / …‘を'二つに(部分に)分ける;(各部分に)‘を'分ける)《+『名』+『into』(『in』)+『名』》 / (…から)…を引き離す,分ける《+『名』+『from』+『名』》 / (二つ以上の部分に)『分かれる』 / 『別れる』 / (物を)手放す,処分する《+『with』+『名』〈物〉》 / 一部分は,部分的に,幾分 
past	 『過ぎ去った』,終わった(over) / 《名詞の前にのみ用いて》『過去に起こった』,過去の,昔の / 《期間を表す語の前後で完了形の文で用いて》(…の期間を)『過ぎた』,最近(…)の / 《名詞の前にのみ用いて》『前任の』,元の / (文法で)過去の / (場所)『を通り越して』,の先に / (時刻)『を過ぎて』;(年齢)を過ぎて / (能力・限度など)『を越えて』,の及ばない / (ある数・量)『を越えて』,…以上 / 《the~》『過去』 / 《a~,one's~》(国などの)歴史;(人の)経歴,(特にいかがわしい)過去 / 過去[時制];過去形 / 『過ぎて』,通り越して 
pate	 頭,脳天;頭脳 
path	 (自然にできた)『小道』,細道;庭内の道 / (人・物の)『通り道』,通路・進路,軌道《+『of』+『名』》 / (行動の方針としての)(の)道《+『of』+『名』》)への)道程《+『to』+『名』》 
pave	 (アスファルトなどで)…‘を'『舗装する』《+『名』+『with』+『名』》 
pawl	 (歯車の)歯止め,つめ 
pawn	 〈大事な物〉‘を'資(抵当)に入れる / 〈生命・名誉など〉‘に'かけて誓う / 〈C〉質草,抵当物 / 〈U〉質入れ・質
peak	 (とがった)『山頂』,峰;最も高い所 / (独立した)鋭峰,孤峰 / 『とがった先』,先端 / (事の)最頂点,絶頂,ピーク / (帽子の)前びさし / 最高の,最大の,ピークの / 頂点に達する,最高(最大)になる 
peal	 鐘の響き,チャイムの音 / チャイム / (雷・笑い声などの)響き,とどろき《+『of』+『名』》 / 〈鐘など〉‘を'鳴り響かせる / 鳴り響く,とどろく 
pear	 『西洋ナシ』;西洋ナシの木 
peat	 ピート,泥炭(でいたん) 
peck	 …‘を'『くちばしでつつく』 / 〈穴など〉‘を'くちばし(とがった道具)でつついて開ける / 〈鳥が〉…‘を'ついばむ / 《話》(あいさつなど)〈人〉‘に'軽いキスをする / (…を)『くちばしでつつく』《+『at』+『名』》 
pelf	 《通例軽べつして》金銭(money),(不正で得た)富(wealth) 
pelt	 〈石など〉‘を'(…に)立て続けに投げる《+『名』〈石など〉+『at』+『名』》;…‘に'(石などを)投げて攻撃する《+『名』+『with』+『名』〈石など〉》 / 〈打撃・砲弾・雨などが〉…‘を'続けて打つ / 〈雨などが〉激しくたたきつけるように降る《+『down』》 / 急いで走る,疾走する / 強打 
pent	 penの過去・過去分詞 
peon	 (中南米・米国南西部の農園で,しばしば借金のかたとして働かされる)未熟練労働者 
perk	 〈頭・尾など〉‘を'ぴんと上げる《+『up』+『名,』+『名』+『up』》 / 〈人・衣総など〉‘を'さっそうとさせる《『up』+『名,』+『名』+『up』》
perm	 《英話》〈髪〉‘に'パーマをかける / =permanent wave
pert	 生意気な,こしゃくな / 活発な,元気のよい / (服装などが)いきな 
peso	 ペソ(メキシコ・キューバ・フィリピンなどの貨幣単位;《略》『P.』) 
pest	 害虫 / 《話》やっかい者 / 《まれ》ペスト 
phew	 ちぇっ(いらだち・驚き・不快・嫌悪などを表す声);ふうー(疲労・安堵(あんど)などを表す声) 
phut	 ポン,パン(なにかが破裂するようなにぶい音) 
pica	 パイカ活字;(特に1インチに10字打てる)タイプライター用パイプ活字 / 〈C〉パイカ(行の副の単位;約4.2ミリ)
pick	 (入念に)…‘を'『選ぶ』,選び取る / 〈草花・果実など〉‘を'『摘む』,もぐ / 〈鳥など〉‘の'羽をむしる;(…から)…‘を'むしる《+『名』+『from』+『名』》 / (とがった物で)…‘を'つつく,つついて穴をあける《+『名』+『with』+『名』》 / 〈鳥などが〉〈えさ〉‘を'つつく,つついて食べる / 〈争いなど〉‘を'しかける;(人に)〈口論など〉‘を'ふっかける《+『名』+『with』+『名』〈人〉》 / (針金などで)〈錠〉‘を'こじあける / 〈ポケット・さいふなど〉‘の'中身をすり取る / 〈弦楽器・弦〉‘を'指で鳴らす,つまびく / 入念に選ぶ / 〈鳥が〉えさをつつく;(食浴がなくて)〈人が〉(…を)少しずつ食べる《+『at』+『名』》 / 〈U〉(…の)選択(choice),(…を)選ぶこと(権利)《+『of』+『名』》 / 〈C〉(…から)選択された人(物);《the~》(…から)選ばれた最上の人(物)《+『of』+『名』》 
pied	 まだらの,ぶちの 
pier	 『船着き場』,さん橋(さんばし),埠頭(ふとう) / 橋脚 / (窓と窓の間の)窓間(まどあい)壁 
pike	 やり,ほこ(17世紀末まで歩兵が武器として用いた) / (やり・ほこの)…‘を'突き刺す
pile	 〈C〉(…の)『積み重ね』《+『of』+『名』》 / 《話》『多数』(…の),たくさん(の…),大量(の…)《+『of』+『名』》 / 《a~》《話》大金 / 〈C〉大建築物[群] / 〈C〉=nuclear reactor / 《副詞[句]を伴って》…‘を'『積み重ねる』,積み上げる / (…を)〈容器〉‘に'積み上げる,盛る《+『名』+『with』+『名』》 / …‘を'畜積する,ためる《+『輝箇』+『名,』+『名』+『up』》 / 『積み重なる』,積もる《+『up』》 / 《話》《方向・状態を表す副詞[句]を伴って》どやどやと動く
pine	 (また『pine tree』)〈C〉『松』,松の木 / 〈U〉松材
ping	 (小銃弾などの)ピュー(ブーン)という音 / ピュー(ブーン)と音がする
pink	 〈U〉『桃色,ピング』 / 〈C〉ナデシコ属の植物(ナデシコ・セキチク・カーネーションなど) / 《the pink》《話》最上のもの,極致,粋 / 〈C〉《しばしばPink》《話》左翼的な人,赤がかった人 / 桃色の,ピンクの / 《しばしばPink》左翼的な,赤がかった
pint	 パイント(液量および穀量の単位;《英》では約0.57リットル,《米》では約0.47リットル) 
pith	 (植物の茎の中の)髄;(果実などの)やわらかい部分 / 《the ~》(…の)重要な部分,要点《+『of』+『名』》
pity	 〈U〉(…に対する)『あわれみ』,同情《+『for』+『名』》 / 〈C〉『残念』(『遺憾』)『なこと』,惜しいこと,気の毒なこと / (…で)…‘を'『気の毒に思う』,あわれむ,‘に'同情する《+『名』+『for』+『名』(do『ing』)》 
plan	 『計画』,『案』,プラン,設計 / 『設計図』,『図面』;(小区域の)地図,市街図 / …‘を'『計画する』,‘の'案を立てる / …の設計図をかく,‘を'設計する / 計画を立てる 
plat	 小さな地面(地所) / (土地などの)図面,地図
play	 〈おもに子供が〉(…をして)『遊ぶ』,戯れる《『+at+名(doing)』》 / 『競技(試合)をする』;かけ事をする / 《状態を表す副詞を伴って》勝負する / (劇・映画・テレビで)『演ずる』,役をする / (劇場・テレビで)上演される;〈台本が〉上演できる / (楽器を)『演奏する』《『+on(upon)+名』》 / 〈楽器・音楽が〉演奏される,〈レコード・ラジオなどが〉鳴る / 〈人・動物,木の葉・炎,光・色彩などが〉遊び戯れるように動き回る / 〈水・砲火などが〉(…に)続けざまに放射する《『+on(upon)+名』》 / 〈機械の一部が〉自由に動く / (…と)浮気をする《+『around』(《英》『about』)『with』+『名』》 / (…と)〈競技・ゲーム〉‘を'『する』《+『名』〈競技・ゲーム〉+『with』+『名』》 / 〈人・チーム〉‘と'『試合する』,勝負する / 〈金〉‘を'かける;〈競走馬など〉‘に'かける / (競技・試合で)…‘の'ポジションを守る / (競技・勝負で)〈選手〉‘を'起用する,〈カードなど〉‘を'出す / …‘の'『まねをして遊ぶ』,…ごっこをする / 〈役〉‘を'『演ずる』,…‘の'役を演じる / (実生活で)…‘の'『役割を務める』,…らしくふるまう;…‘に'なりすます / 〈劇など〉‘を'公演する;〈ある場所〉‘で'興行する / 〈いたずら・詐欺など〉‘を'『働く』,しかける / 〈楽器〉‘を'『演奏する』,ひく;〈レコード・ラジオ〉‘を'かける / 〈楽曲〉‘を'『演奏する』,かける / (…に)〈水・砲火・光など〉‘を'続けざまに浴びせる《『+名+on(over, along)+名』》 / 〈C〉『演劇』,芝居;『戯曲』,脚本 / 〈U〉『遊び』,遊戯 / 〈U〉冗談,戯れ,ふざけ(fun, jest) / 〈U〉『競技』,試合;かけ事 / 〈C〉(競技での個々の)動き,プレー;〈U〉競技の番 / 〈U〉試合ぶり;(一般に)行動,行為 / 〈U〉〈C〉遊び戯れるような軽快な動き / 〈U〉(思考力などの)豆き;(機械などの)活動 / 〈U〉動きの自由;(機械の)あそび 
plea	 (…に対する)『嘆願』,懇願《+『of』+『名』》 / 《単数形で》『弁解』,言い訳,口実(excuse) / (…の)抗弁,申し立て《+『of』+『名』》 
pleb	 庶民 
pled	 pleadの過去・過去分詞 
plod	 《方向を表す副詞[句]を伴って》重い足取りで歩く,とぼとぼ歩く《+『on』(『along』,『away』》 / (…に)こつこつと取り組む《+『away』(『along』)『at』(『through』)+『名』》 / とぼとぼ歩くこと 
plot	 『小区画の土地』,小地所 / (小説・劇などの)『筋』,プロット / 『蔭謀』,たくらみ / 〈悪事〉‘を'『ひそかに計画する』,たくらむ / (地図・海図などに)…‘を'書き込む;…‘の'図表(図面)を作る / 〈土地〉‘を'区画する《+『out』+『名,』+『名』+『out』》 / (…に対して…の)『陰謀を企てる』,たくらむ《+『against』+『名』+『about』(『toward』)+『名』(do『ing』) 
ploy	 (相手の先手をとる)手だて,たくらみ,策略 
plug	 (穴・すきまなどをふさぐ)『栓』,くさび / (電気の)『差し込み』,プラグ / 《話》=spark plug / 消火栓(fireplug) / (一口分に切った)かみたばこ / 《話》(テレビ・ラジオの番組にはさんだ)宣伝,広告 / 《米俗》老いぼれ馬 / 〈穴・すきまなど〉‘を'『ふさぐ』,‘に'せんをする《+『up』+『名』,+『名』+『up』》 / …‘の'プラグを努し込む《+『in』+『名,』+『名』+『in』》;コンセントに)…‘の'プラグを努し込む《+『名』+『into』+『名』》 / 《話》(…に)こつこつ(せっせと)取り組む《+『away』(『along』)『at』+『名』》
plum	 〈C〉『西洋スモモ』;西洋スモモの木 / 〈C〉(プティング・パイなどに入れる)干しぶどう / 〈U〉(西洋スモモに似た)濃紫色 / 〈C〉《話》(人が)手に入れたがるもの(もうけ仕事など) / 濃紫色の,スモモ色した 
plus	 『…を加えて,を足して』 / 《話》『…に加うるに』,とともに / 《名詞の前にのみ用いて》(数学で)『正の』,『プラスの』 / 《名詞の前にのみ用いて》(電気が)『陽の』 / 余分の(extra) / (等級が)…の上 / プラス記号,正号(plus sign)・正数(plus quantity) / 《話》剰余(じょうよ),利益;付加的な要素
pock	 あばた 
poem	 (一編の)『詩』 / 詩的な美しさ(趣き)を持つもの
poet	 『詩人』,歌人 / 詩的才能のある人
poke	 (とがったもので)…‘を'『突く』,つつく《+『名』+『名』+『with』+『名』》 / (…に)…‘を'突っ込む《+『名』+『into』+『名』》;(…から)…‘を'突き出す《+『名』+『out of』+『名』》 / (…に)〈穴〉‘を'つついて作る《+『名』+『in(through)』+『名』》 / 《話》…‘を'こぶしでなぐる(打つ) / (…を)『突く』,つつく《+『at』+『名』》 / (…から)突き出る《+『out of』+『名』》 / (指ひじ・棒などで)突くこと / 《話》(こぶしで)打つこと
pole	 (木製・金属性などの)『棒』,さお / 柱 / (牛車・馬車の)ながえ / ボール(長さの単位,5.03メートル;面積の単位,25.3平方メートル) / …‘を'棒で動かす(押す,突く,たたく) 
poly	 =polytechnic 
pond	 『池』 
pone	 =corn pone 
pony	 小型の品種の馬;(一般に)小さい馬 / 《米俗》(外国語や古典の対訳の)虎の巻
pore	 《pore over+名》(…を)熟読する,注意深く考える・没頭する, 熟考［熟視，熟読］する 
pork	 豚肉 
porn	 =pornography 
port	 〈C〉〈U〉『港』 / 〈C〉『港町』,『港市』
pose	 (絵や写真のモデルとして)『姿勢をとる』《+『for』+『名』》 / (特に他人に印象づけようとして)気どる;(…の)ふりをする《+『as』+『名』》 / 〈モデルなど〉‘に'姿勢をとらせる;〈被写特など〉‘を'適当な位置に配する / 〈『難問など』〉‘が'生じる / 〈要求・質問など〉‘を'述べる,提出する / (絵や写真のためにとる)『ポーズ』,『姿勢』 / (人に見せるための)ポーズ,見せかけ,気どり 
posh	 すばらしい,りっぱな / 高級な,豪華な
post	 〈C〉(木・金属・石などの)『柱』,『支柱』,くい / 《the ~》(競馬の)出発標,決勝標 / 〈C〉《話》(ラグビーなどの)ゴールポスト(goalpost) / (柱・壁などに)〈掲示物〉‘を'『張る』,張り出す《+『名』〈掲示物〉+『on』+『名』》;(掲示物を)〈柱・壁など〉‘に'張る《+『名』+『with』+『名』〈掲示物〉》 / (掲示して)…‘を'公表する,公示する / 《通例受動態で》(…として)…‘を'掲示(発表)する《+『名』+『as』+『現分』(過分)》
posy	 花(flower) / 花束(bouquet)
pour	 《副詞[句]を伴って》〈液体〉‘を'『注ぐ』,『つぐ』,流す / (…に)…‘を'『注ぎかける』,溶びせる,〈努力など〉‘を'注ぐ《+『out』(forth』)+『名,』+『名』+out』(『forth』)》 / 《副詞[句]を伴って》〈水・煙などが〉『流れる』;《比喩(ひゆ)的に》〈人・物が〉『流れ出る』 / 〈雨が〉『激しく降る』《+『down』》 / 《話》(レセプションなどで)〈婦人が〉お茶(コーヒーなど)をつぐ,接待役をする / どしゃ降り
pout	 (不快・不きげんを表して)口をとがらせる,ふくれっつらをする / (くちびるなど)‘を'とがらせる《+『out』+『名』》 / 口をとがらせること 
pram	 =perambulator 
prat	 まぬけ,ばか 
pray	 (神に…を)『祈る』《『to』+『名』〈神〉+『for』+『名』》 / 《話》(物事を)心から望む《+『for』+『名』》 / 〈神〉‘に'『祈願する』,祈る / 《『pray』+『that』『節』》…であることを心から望む / 《文》…‘を'懇願する,請う / 《改まった命令文で》どうか(please);《疑問文で》ねえ,もし
prey	 〈U〉(肉食獣・鳥の)『えじき』 / 〈C〉《単数形で》《比喩(ひゆ)的に》(…の)えじき(儀牲)となる人(物)《+『of』(『to』,『for』 )+『名』》 / 〈U〉(動物・鳥が)肉食をかること;肉食の習性 / 〈獣などが〉獲物をあさる;(…を)えじきにする《+『on』(『upon』)+『名』》 / 〈人が〉(…を)えじきにする《+『on』(『upon』)+『名』》 / 〈物事が〉(心を)苦しめる,さいなむ《+『on』(『upon』)+『名』》
prig	 気取り屋,口やかまし屋 
prim	 きちんとした / (女性が)取り澄ました
prod	 突き刺す(つつく)こと / 刺し針,突き棒 / (一般に)刺激 / (先のとがったもので)…‘を'突き刺す,つつく《+『名』+『with』+『名』》 / …‘を'刺激する,呼び起こす;〈人〉‘を'励まして(…を)促す《+『名〈人〉+『to』(『into』)+『名』(do『ing』)》 / (…を)突く,つつく《+『at』+『名』》
prom	 《米話》(特に高校・大学などで公式に行う)ダンスパーティー / 《英話》=promenade concert / 《英話》=promenade2 
prow	 《おもに文》船首,へさき(bow);機首 
puce	 暗褐色 / 暗褐色の
puck	 (アイスホッケーの)パック 
puke	 …‘を'吐く,もどす / 嘔吐(おうと)した物 / 吐くこと,嘔吐 
pule	 〈赤ん坊が〉弱々しく泣く 
puma	 =cougar 
punk	 (点火用の)つけ木 
punt	 パント舟(長いさおで川底を突いて進む,両端が四角い平底の浅瀬用の小舟) / 〈舟〉‘を'長ざおで進める;〈人・物〉‘を'パント舟で運ぶ / パント舟で進む 
puny	 ちっぽけな,か弱い / 大したことのない
pure	 (金など)『混じりけのない』,純粋の / (水など)『汚れていない』,きれいな / (道徳的に)汚れていない,清らかな / (血統が)純粋の,純血の,きっすいの / 《名詞の前にのみ用いて》《話》全くの / 《名詞の前にのみ用いて》(応用的に対して)理論的な,純粋の
purl	 〈小川などが〉さらさらと流れる / さらさらと流れる音
push	 《副詞[句]を伴って》(動かすために)…‘を'『押す』,押して動かす / 〈提案・要求など〉‘を'押し進める,推進する / 〈人〉‘に'押しつける / …‘を'拡張する,伸ばす / 〈商品など〉‘を'押しつける / 《話》《進行形で》〈ある年齢〉‘に'近付く / (動かすために)(…を)『押す』,突く,押し動かす / 《方向を表す副詞[句]を伴って》押し進む / 〈C〉ひと押し / 〈C〉奮闘,努力
pyre	 (死体を焼くのに使う)積みまき・火葬用の薪の山 
quad	 =quadrangle2 
quay	 はとば,埠頭(ふとう) 
quid	 1ポンド[の金額] 
quin	 =quintuplet・五つ子の一人 / 《複数形で》五つ子 / (特に同種の)5個(5人)一組 
quip	 (特に当意即妙な)警句,気のきいた言葉 / しんらつな言葉 / 気のきいたこと(皮肉)を言う 
quit	 …‘を'『やめる』,『中止する』 / 〈職・地位など〉‘を'『断念する』,『此てる』,放棄する / 《英では古》〈人・土地など〉‘から'去る / やめる,中止する / 辞職(退職)する / (敗北を認めなどして)断念する / 去る;立ちのく / (…を)免れた,(…から)自由な《+『of』+『名』》
quiz	 『小テスト』 / 『クイズ』 / (…について)《人》‘に'質問する,試験する《+『名』《人》+『about』(『no』)+『名』》 
quod	 監獄 
race	 競走,レース;競技会,(特に)競馬 / (一般に)競争;(…を得るための)競争《+『for』+『名』》 / 水の速い流れ,急流,早瀬;(水車などの)水路 / 《おもに文》(事件・話などの)進行;(太陽・月の)運行;)時の)経過;人生の行路 / (…と)『競走する』《+『with』(『against』)+『名』》,(…のために)『競争する』《+『for』+『名』》 / 《方向などの副詞[句]を伴って》疾走する,急ぐ / 〈機械などが〉高速で作動する,〈エンジンなどが〉空転する / …と『競走する』 / (…と)…‘を'『競走させる』,全速力で走らせる《+『名』+『against』+『名』》 / 〈機械など〉‘を'高速で作動させる,〈エンジンなど〉‘を'空転させる
rack	 《しばしば複合語を作って》(枠・網・棒などで作られた)…『掛け』,…『のせ』,…『棚』(たな)陳列棚;網棚 / 歯ざお(歯車を受ける直線のかみ合せ歯) / (昔の)拷問(ごうもん)台;《『the~』》拷問;(肉体・精神の)苦痛 / (肉体的・精神的に)(…で)〈人〉‘を'苦しめる,悩ませる《+『名』+『with』+『名』》・「rack one's brains」で「知恵を絞る」
racy	 独特の風味の / (話し方・文体などが)生きのいい,きびきびした / ちょっときわどい 
raft	 いかだ / =life raft / 〈海・川など〉‘を'いかだで渡る;…‘を'いかだで運ぶ / 〈材木〉‘を'いかだに組んで運ぶ / いかだで行く 
rage	 〈U〉〈C〉『激怒』,憤激 / 〈U〉〈C〉《おもに文》(風・波などの)『猛威』,激しさ《+『of』+『名』》 / 〈U〉〈C〉(感情・欲望などの)激しさ,強烈さ《+『of』+『名』》 / 〈C〉(…に対する)熱望,熱情《+『for』+『名』(do『ing』)》 / 〈C〉《話》(一時的に)『大流行しているもの』 / (…に)『激怒する』,憤激する《+『against』(『about,at,over』)+『名』(do『ing』)》 / 〈風・波などが〉『荒れ狂う』,猛威をふるう 
raid	 (…への)『襲撃』,奇襲;(警察の)手入れ《+『on(upon)』+『名』》 / …‘を'急襲する;〈警察が〉…‘を'手入れする / 急襲する 
rail	 〈C〉(かきね・柵(さく)などの)『横棒』,横木;手すり,らんかん,《複数形で》柵,かき / 〈C〉(鉄道の)『レール』 / 〈U〉(輸送機関としての)『鉄道』 / 〈C〉(物を掛けたりするための)横木,横棒 / …‘を'横木(手すり)で囲む,‘に'柵を付ける《+『in(off)』+『名』》 
rain	 〈U〉〈C〉『雨』,雨降り,降雨 / 《the rains》(熱帯地方などの)雨期,雨季 / 〈C〉《比喩(ひゆ)的に》《a ~》(…の)雨《+『of』+『名』〈複数〉》 / 《通例itを主語にして》『雨が降る』 / 雨のように降る / (…に)…‘を'雨のように降らす《+『名』+『on』(『upon』)+『名』》
rake	 熊手（くまで）,草かき;くまでの形の道具(賭博(とばく)場で金を集めるのに使うものなど) / …‘を'くまででかき集める;〈場所〉‘を'くまででかきならす《+『together(up)』+『名,』+『名』+『together(up)』》 / (…を求めて)〈場所〉‘を'くまなく捜す《+『名』+『for』+『名』》 / …‘を'機銃掃射する / くまでで集める(かきならす) / (…を求めて)かきわけて捜す《+『for』+『名』》・「rake it in」で《口語》 金をうんともうける[稼ぐ]
ramp	 詐欺,かたり 
rand	 ラント(南アフリカ共和国の通貨の単位) 
rang	 ringの過去 
rani	 =ranee 
rank	 〈C〉〈U〉『階級』,等級;(相対的な)『順位』,地位: / 〈U〉高い地位(身分) / 〈C〉〈U〉(人・物の)『列』,並び;(兵隊)の横列 / 《the ranks》(また『rank and file』)(将校たちに対して)兵卒,下士官 / …‘を'『並べる』 / …‘を'『位置づける』,評価する / 《米》…‘より'上位にある / 『位置する』・「pull one's rank on 誰々」で「(誰々に)地位を悪用する; (意見が衝突したような場合に)階級をかさに着て(誰々に)命令を押しつける」
rant	 大げさに言う / …‘を'大げさに言う《『out』+『名,』+『名』+『out』》 / 大げさな話 
rape	 〈婦女〉‘を'暴行する,強姦(ごうかん)する / 婦女暴行,強姦
rapt	 うっとりとした,没頭したした;(…に)心奪われた《+『in』+『名』》 
rash	 (人・行動などが)『向こう見ずな』,無分別な(reckless);性急な 
rasp	 (木材用の)粗(あら)やすり / ガリガリ(ギリギリ)いう音,きしむ音 / …‘を'粗やすりでこする,研摩する《+『off)away)』+『名』,+『名』+『off(away)』》 / 〈神経・感情など〉‘を'いらだたせる,さかなでする / …‘を'きしるような声で言う《+『out』+『名』,+『名』+『out』》 / 耳ざわりな音を出す,きしる
rate	 〈C〉『割合』,『率』 / 〈C〉《the~,a~》『速度』(speed),進度 / 〈C〉『値段』,『相場』;料金 / 〈U〉等級(class),(…)等 / 《複数形》《英》地方税 / (…の金額に)…‘の'『値段を決める』,見積もる《+『名』+『at』+『名』》 / …‘を'『評価する』,みなす / 《米話》…‘に'値する,‘の'価値がある / 『評価される』;みなされる 
rats	 ばかな,信じられない 
rave	 (…について)とりとめのないことを言う《+『about』+『名』(do『ing』)》;(…にむかって)わめき散らす《+『against(at)』+『名』》 / 《話》(…について)熱っぽく語る,ほめちぎる《+『about』+『名』(do『ing』)》 / とりとめのないことを言うこと;わめくこと / 《話》べたぼめ / べたぼめの 
raze	 〈町・家など〉‘を'跡形もなく破壊する 
read	 〈書かれた物・印刷された物〉‘を'『読む』 / 〈書かれた物・印刷された物〉‘を'『読み上げる』,読んで聞かせる / 〈外国語・文学・記号など〉を判読する,解読する / 〈事〉‘を'『読んで知る』 / 〈隠れた意味など〉‘を'『読み取る』,見抜く / 〈計器・時計が〉…‘を'示す,表示する(show) / 《文》(…を)…‘と'訂正して読む,読み替える《+『名』+『for』+『名』》 / 《英》(大学で)…‘を'学ぶ,専攻する / 『本を読む』,読書する / 『音読する』;(人に)読み上げる《+『to』+『名』》 / (…のことを)読んで知る《+『about』(『of』)+『名』》 / 《副詞[句]を伴って》〈本などが〉(…と)読める,読んでみると(…)である,〈物事が〉(…と)解釈される
real	 (想像でなく)『現実の』,実際の,真実の / (まがいものでなく)『本物の』 / 不動産の / ほんとうに,とても(very)
ream	 (一定の規格に裁断した紙の)連(れん)(1連は20帖(quire);《英》480枚,《米》500枚;新聞では 500枚,印刷用紙では516枚) / 《複数形で》《話》(おもに書き物の)多量,たくさん《+『of』+『名』》
reap	 〈穀類〉‘を'『刈る』 / 〈作物〉‘を'『刈り入れる』,収穫する / 〈畑〉‘から'作物を刈る(収穫する) / …‘で'『報いられる』;〈利益・報酬〉‘を'特る / 刈り取る,収穫する;《比喩(ひゆ)的に》利益を受ける 
reck	 …‘を'気にかける,こだわる / (…を)気にかける《+『of』+『名』》
redo	 …‘を'再びする,やり直す 
reft	 (…を)奪われて,失って《+『of』+『名』》 
rein	 《しばしば複数形で》『手綱』 / (…に対する)制御手段;統御力;制御,統率《+『on』(『over』)+『名』》 / 〈人が〉〈馬など〉‘を'手綱で操る,御する / 〈人が〉〈感情など〉‘を'抑制する
rely	 『あてにする』,たよる 
rend	 …‘を'引き裂く,引きちぎる / (…から)…‘を'もぎ取る《+『名』+『off from』+『名』》 / …‘を'引き裂くように割る(分議させる) 
rent	 (…の)ほころび;裂け目;嶺れ目,割れ目《+『in』+『名』》 / (…の)分裂,不和《+『in』+『名』》
rest	 〈U〉〈C〉『休息』,休憩,休養;休息の時間(期間);(…から)解放されて休むこと《+『from』+『名』》 / 〈U〉〈C〉睡眠(sleep) / 動かないこと,停止,静止 / 〈C〉《複合語に用いて》「(物を載せる)台,支え」の意を表す / 〈U〉《詩》死,永眠 / 〈C〉(音楽で)休止;休止符 / 『休む』,『休息する』;(仕事などを)やめて休む《+『from』+『名』》 / 『安心する』,落ち着く,くつろぐ / (…に)『載っている』,『支えられている』《+『on』(『upon』)+『名』》;(…に)もたれている(lean)《+『against』+『名』》 / 〈光・視線などが〉(…に)注がれる,じっと留まる《+『on』(『upon』)+『名』》 / (変化しないで)そのままでいる,休止(静止)する / 永眠する / (訴訟事件で)証拠提出を自発的に中止する / 《しばしば受動態で》…‘を'『休息(休養)させる』,休ませる / (…に)…‘を'置く,載せる,基づかせる《+『名』+『on』(『upon』)+『名』(do『ing』)》;(…に)…‘を'よりかからせる》+『名』+『against』+『名』》 / 〈訴訟事件〉‘の'証拠提出を自発的に中止する
rhea	 アメリカダチョウ(南米産) 
rial	 リアル(イランの通貨の単位) 
rice	 『米』(欧米ではプディングやケーキの原料にも用いる) / イネ(稲) / 〈ゆでたジャガイモ・カボチャなど〉‘を'ライサー(ricer)で米粒ほどの太さのそうめん状にする 
rich	 『金持ちの』,『富んだ』,豊かな / 《名詞的に》《the~;複数扱い》金持ちの人たち / (衣服・宝石・家具などが)高価でみごとな,ぜいたくな / (想像力などが)豊かな;(土地が)肥えた / (音・声が)豊かな,深みのある;(色が)濃い,あざやかな;(料理・酒の問が)濃くておいしい;(香りが)強い / 濃度が高い;(特に食物の)栄養価が高い,(油・卵・バターなどを多く含んで)濃厚な / 《話》非常におもしろい,こっけいな;《反晴的に》とんでもない,ばかげた 
rick	 (通例雨を防ぐ屋根のついた,干し草・ワラ・穀物などの)積み山,《+『of』+『名』》 / 〈干し草・わらなど〉‘を'山に積む　積みわら
ride	 (馬・自転車・電車などに)『乗って行く』,『乗っている』《+『on』(『in』)+『名』》;乗馬をする,馬に乗る / (人の肩・背などに)馬乗りになる,またがる《+『on』+『名』》 / 《副詞[句]を伴って》(波間・空間などに)浮かぶ;(波・風に)乗って進む / (…に)支えられて(載せられて)動く《+『on』(『upon』)+『名』》 / 《状態を表す副詞[句]を伴って》〈馬・車などが〉乗りごこちが…である;〈地面・走路などが〉走りごこちが…である / (正常な位置から)〈衣服などが〉ずり上がる,持ち上がる《+『up』》 / 《話》(中断されずに)そのまま進行する / 〈馬・自転車・電車など〉‘に'『乗って行く』 / 〈風・波など〉‘に'乗って進む(運ばれる) / 《副詞[句]を伴って》(乗物などに)〈人・物〉‘を'乗せて行く,乗せて運ぶ / 〈道路・地域など〉‘を'馬で進む,乗物で通る / 《おもに米話》(…のことで)〈人〉‘を'からかう,あざける《+『名』+『about』+『名』》 / (馬・乗物などに)乗ること;(馬・乗物などを利用した)小旅行 / 遊園地の乗物(大回転観覧車・回転木馬・ジェットコースターなど) / (特に,森の中の)乗馬道 / (馬・乗物などの)乗りごこち / 〈人〉を自動車で連れ出して殺す 
rife	 (うわさ・犯罪・悪疫などが)広まって《widespread) / (望ましくないもので)満ちた《+『with』+『名』》
rift	 (…の)切れ目,割れ目《+『in』+『名』》・分裂・ / (…間の)仲たがい《+『between』+『名』》 / …‘を'割れる,裂ける 
rile	 …‘を'怒らせる,いらいらさせる / = roil
rime	 霜,白霜(hoarfrost) / …‘を'霜でおおう
rind	 (果物・チーズなどの)皮,外皮 
ring	 『指輪』 / 『輪』,環;輪形,円形 / (円形の)サーカス演技場,公演場,競技場;(ボクシング・レスリングの)リング / 《複数形で》(体操の)つり輪 / (不法な目的で結託した)(…の)徒党,一味《+『of』+『名』》 / (原子の)環 / …を円形に取り囲む,円で囲む《+『about』(『around』,《英》『round』)+『名,』+『名』+『about』(『around』,《英》『round』)+『名』》 / 〈動物〉‘に'鼻輪(首輪,足輪)をはめる / (遊びで)…‘に'輪を投げる / 環状に動く,輪を描く
rink	 スケートリンク,(屋内)スケート場,ローラースケート場 
riot	 〈C〉『暴動』,騒動;騒擾(そうじょう) / 《a~》(色・音などの)『多彩』,はなやかさ;(感情・想像などの)ほとばしり,奔放《+『of』+『名』》 / 〈C〉《話》非常に愉快な(おもしろい)人(事,物) / 暴動(騒動)に加わる,暴動を起こす / (…に)ふける,おぼれる《+『in』+『名』(do『ing』)》 
ripe	 (果物・穀物などが)『熟した』,うれた / (人・精神などが)『円熟した』成熟した / 《補語にのみ用いて》(…の)用意ができている;)…の)機の熟した《+『for』+『名』》 / 老齢に達した
rise	 《文》『立ち上がる』《+『up』》 / 《文》『起床する』,起きる / (下から上へ)『上がる』,上昇する,昇る / 〈土地が〉上り[坂]になる / 〈山・建物などが〉そびえ立つ(進行形にできない) / 〈…の数量・価値・程度・力などが〉増す,増大する,増加する / 〈地位・身分などが〉(…から…へ)上がる,高くなる《+『from』+『名』+『to』+『名』》 / 〈川などが〉高さを増す,増水する / 〈パンなどが〉ふくれる / (…に)源を発する,始まる《+『from』(『in』)+『名』》(進行形にできない) / (…に)反乱を起こす,背いて立ち上がる《+『against』+『名』》 / 生き返る,よみがえる / (表面に)浮かび上がる / (…に)応じて立ち上がる,うまく対処する《+『to』+『名』》 / 〈C〉(…の)『上昇』《+『of』+『名』》 / 〈C〉(数量・価値・程度などの)増大,増加《+『in』(『of』)+『名』》 / 〈U〉立身;繁栄 / 〈C〉(…の)上り坂,上り勾配(こうばい)《+『in』(『of』)+『名』》 / 〈C〉丘,高台 / 〈C〉(…の)起源,始まり《+『of』+『名』》 / 《英話》昇給,昇給額(《米》raise) / 〈C〉魚がえさを求めて水面に浮き上がること
risk	 『危険』;危害(損害)を受ける可能性《+『of』+『名』(do『ing』)》 / 〈生命など〉‘を'『危険にさらす』 / …‘を'危険(失敗,損失など)を覚悟してする 
rite	 (通例宗教的な)儀式 
rive	 …‘を'割る,裂く / 〈心など〉…‘を'引き裂く
road	 『道路』,『道』;街道 / (都市・町の)…街,…通り(street);《the…Roadとして》…街道;通例Rdと訳し固有名詞に付て / (ある目的に至る)『道』(course),手段(means)《+『to』+『名』》 / 鉄道(railroad) / =roadstead 
roam	 (特に広い地域を)あてもなく歩き回る,放浪する(wander)《+『about』(『around』(《英》『round)』),『through』,『over』)+『名』》 / …‘を'歩き回る,放浪する
roan	 (馬などが)あし毛の / あし毛の動物(特に,馬) / あし毛色 
robe	 『ローブ』(長いゆったりとした外衣;特に化粧着・部屋着・バスローブなど) / 《しばしば複数形で》(すそまでの長いゆったりした)礼服,式服,職服,法衣 / 《米》(戸外競技を見るときにひざなどにかける毛皮・布・編物などの,暖かい)おおい / (礼服・式服などを)〈人〉‘に'ゆったりとまとわせる《+『名』+『in』+『名』》 / ローブ(礼服・式服など)を着る 
rock	 〈U〉〈C〉『岩』,岩石;『岩壁』;《しばしば複数形で》岩礁 / 〈C〉『岩片』;《米話》『石』,小石 / 〈C〉岩のように強固(堅固)なもの,しっかりして頼りになるもの 
rode	 rideの過去形 
roil	 (また《米》『rile』)〈液体〉‘を'かき乱す(濁す) / 〈人〉‘を'怒らせる,いら立たせる
role	 (役者が演じる)『役』 / (一般に)『役割』,任務
romp	 はしゃぎ回る,ふざけ回る《+『about』(『around』)》 / (レースで)楽勝する / おてんば娘;はね回る子供 / 騒々しい遊び;はね回り
rope	 〈U〉『なわ』,綱,ロープ;〈C〉(1本の)なわ / 〈C〉一つながり(の…)《+『of』++『名』》 / 《the~》絞首索;絞首刑 / 〈C〉投げなわ / 《複数形で》ロープス(ボクシングなどでリングを囲った綱) / …‘を'なわで縛る(くくる)《+『up』+『名,??+『名』+『up』》 / 〈場所〉‘を'なわで囲う(仕昔る)《+『off』+『名』,+『名』+『off』》 / 《米》…‘を'投げなわで捕らえる / 〈登山者が〉ロープで体を結び合わせる《+『up』》 / 〈登山者が〉(…を)ロープで登る(降りる)《+『up』(『down』)+『名』》
ropy	 ひどい[状態の] 
rose	 〈C〉『バラの花』 / 〈C〉バラの木 / 〈U〉バラ色,淡紅色 / 〈C〉(形が)バラに似た物:(じょうろの)散水口;(リボンなどの)バラ結び;バラ模様(飾り) / 『バラ色の』 / バラの
rosy	 (特に,肌色について)『バラ色の』 / 希望に満ちた,楽観的な
rote	 機械的なやり方(反復) 
roue	 放とう者 
rout	 大敗北 / (敗北の後の)総崩れ,敗走 / …‘を'敗走させる 
roux	 ルー(小麦粉をバターでいためたもので,スープやソースにとろみをつけるのに用いる) 
rove	 reeveの過去・過去分詞 
rube	 いなかっぺ,いなか者 
ruby	 〈C〉紅玉,ルビー / 〈U〉ルビー色,深紅色(しんこうしょく) / ルビー色の,深紅の,日本発のプログラミング言語 
ruck	 (布についた)しわ 
rude	 (人・人の行為が)『失礼な』,無作法な / 《名詞の前にのみ用いて》大ざっぱに作った,粗雑な / 《名詞の前にのみ用いて》荒々しい,激しい,突然の / 未開の,原始的な / 《名詞の前にのみ用いて》未加工の,自然のままの 
ruin	 〈U〉(…の)『破滅』,崩壊,没落;破産《+『of』+『名』》 / 〈C〉崩壊(荒廃)した物,残がい;《複数形で》『廃墟』(はいきょ) / 《単数形で》破滅(崩壊)させるもの(原因) / …‘を'『波滅させる』,崩壊させる,荒壊させる,〈人・会社など〉‘を'破産させる / …‘を'台なしにする,だめにする 
rule	 〈C〉『規則』,規定;法則 / 〈C〉『慣例』,慣習;通例,通則 / 〈U〉『支配』,統治;統治期間;統治権 / 〈C〉ものさし,定規(ruler) / 〈国・人など〉‘を'『支配する』,統治する,統御する / 《しばしば受動態で》〈感情などが〉〈人,人の行動など〉‘を'左右する,動かす / 〈裁判所・裁判官などが〉…‘と'裁決する,決定する / 〈紙〉‘に'線を引く / (…を)『支配する』,統治する《+『over』+『名』》 / (…について)裁決する,判定する《+『on』+『名』》;(…に反対の)裁決をする《+『against』+『名』(do『ing』)》・〈米俗〉抜群である、最高である
rump	 〈C〉(鳥獣の)臀(でん)部,(人の)しり / 〈U〉(特に牛の)しり肉
rune	 ルーン文字(古代の北欧文字)・神秘的(魔術的)に書かれた文字 / 古代スカンジナビアの詩(歌)
rung	 ringの過去分詞 
runt	 (同種の中で)普通より小さい(発育不良の)動物・(動物のひと腹の子の中で発育不良の)小さな子・できそこない・軽べつして》ちび 
ruse	 (敵を欺く)計略,策略 
rush	 トウシンソウ(灯心草);灯心草の茎(マット・かごなどを作る) 
rusk	 ラスク(甘味をつけた薄切りのパンを天火で焼いたもの) / ソフトラスク(軽く柔らかい甘い乳児用のビスケット)
rust	 (金属の)『さび』 / さび病;さび菌 / さび色 / さびる / 〈能力などが〉(使わずに)鈍る / 〈植物が〉さび病にかかる / 〈金属〉‘を'さびさせる / さび色の
sack	 〈C〉(丈夫な布(革)製の)『大袋』 / 〈C〉《おもに米》(一般に)袋,(特に,購入した食料を入れる)紙袋　〈C〉(婦人・子供用の)ゆったりして短い上着 / 《the ~》《米俗》ベッド,寝袋 / 〈U〉《the ~》《俗》(…からの)解雇《+『from』+『名』》 / …‘を'袋に入れる / 《話》〈人〉‘を'解雇する
safe	 安全な,危険のない / 《come,arrive,bring,keepなどの補語にのみ用いて》無事な(に) / 危険を引き起こさない,危害を加えない / 安全を心がける,危険をおかさない / 『確かな』,まちがいのない / (野球で)セーフの / 『金庫』 / (食料などを入れる)安全戸棚,貯蔵容器
sage	 (通例経験に富んだ年輩の)賢人 / 思慮深い,賢明な
sago	 サゴ(サゴヤシの幹から製するでんぷん) / =sago palm
said	 sayの過去・過去分詞 / 前記の前述の
sail	 〈C〉〈U〉『帆』;《集合的に》一隻の帆全部 / 〈C〉帆のような物;風車の羽根,カエデの種子の羽根など / 〈C〉《単複同形で》帆船;船 / 〈C〉《単数形で》(短い)船旅,船遊び;〈U〉《時にa sail》航程 / 《副詞[句]を伴って》〈船が〉『航海する』 / (…から…へ)『出航する』《+『from』+『名』+『for』(『to』)+『名』》 / 《副詞[句]を伴って》〈人が〉『船で旅をする』,航海する / ヨットを操る,帆走する / 《副詞[句]を伴って》すべるように進む(飛ぶ);〈人が〉さっそうと歩く / 〈人・船などが〉〈海・川など〉‘を'渡る / 〈船〉‘を'操る,走らせる 
sake	 『ため』;利益;理由,目的 
sale	 〈U〉〈C〉(…の)『販売』,売却,売れ行き,需要《+『of』(『for』)+『名』》 / 〈C〉『特売』,安売り / 《複数形で》販売[の仕事];売り上げ[高] 
salt	 〈U〉『塩』,食塩 / 〈U〉(化学で)塩 / 《複数形で》薬用塩類(Epsom salt[s],smelling salts) / 〈U〉生気(刺激,興趣)を与えるもの / 〈C〉《話》(特に老練な)水夫 / 塩の,塩を含んでいる;塩気のある,塩辛い / 塩漬けにした / (土地が)塩につかった / 塩信でできた,塩水の中で育つ / 〈食べ物〉‘を'塩で味をつける;〈肉・魚など〉‘を'塩漬けにして保存する《+『名』+『down』,+『down』+『名』》 / 《受動態で》(…で)〈言葉・話など〉‘を'ぴりっとさせる,‘に'味をつける《+『名』+『with』+『名』》 
same	 《the same》(いつもと)『同じ』,(以前と)変わらない / 《the same》(…と)『同一の』,同じ;同種の《+『as節』(『that節』,『wh-節』)》 / 《this,these,that,thoseと共に》《強調的,時に軽べつして》この,その,例の,前に述べた / 同じ物,同じ事 / 同様に 
sand	 〈U〉『砂』 / 《複数形で》砂地,砂浜,砂漠 / 《複数形で》時刻,時間 / …‘を'砂(紙やすり)で磨く《+『down』+『名,』+『名』+『down』》 / 〈道路など〉‘に'砂をまく 
sane	 (人が)『正気の』,気の確かな / (考え方・判断などが)『思慮(分別)のある』
sang	 singの過去 
sank	 sinkの過去 
sari	 サリー(インド婦人のつける巻き布の衣服) 
sate	 〈欲望・食欲など〉‘を'満足させる / 《受動態で》(…で)〈人〉‘を'飽き飽きさせる《+『名』+『with』+『名』》
save	 (危害・損失・危機などから)‘を'『救う』,救援する《+『名』+『from』+『名』》 / 〈金など〉‘を'』残しておく』,蓄える / …‘を'『節約する』,省く / …‘を'『安全』(『無傷』)『に保つ』,保護する / …‘を'削から急う / (…のために)貯金する《+『up for』+『名』》 / (…を)節約する《+『on』+『名』》 / (サッカー・ホッケーなどで)敵の得点を妨げること
sawn	 sawの過去分詞 
scab	 (傷口の)かさぶた / 《話》(労働組合にはいらない)非組合員;スト破り / スト破りをする 
scam	 悪だくみ,ぺてん / …‘を'だまし取る
scan	 …‘を'じっと見る,詳しく調べる;〈広い区域〉‘を'端から端までよく見る / …‘に'さっと目を通す,‘を'ざっと読む / 〈詩〉‘の'韻律を調べる,‘を'詩脚に分ける / (テレビ・レーダーで)〈映像〉‘を'走査する / 詩の韻律を調べる;〈詩行が〉韻律の法則に合う,音脚が合う / (テレビ・レーダーで)走査をする / じっと見ること,吟味 
scar	 (皮膚の)『傷跡』;(物の表面の)傷跡 / 心の傷跡,痛手;(名誉などを傷つける)汚点 / (植物の茎などに残る)葉印,葉痕(ようこん) / …‘に'傷跡を残す / 〈傷などが〉傷跡を残す《+『over』》 
scat	 (人に)すぐ立ち去れ;(特に猫に)シッシッ,あっちへ行け 
scow	 (泥・石炭などをのせ船で押して運搬する)平底船,スカウ 
scud	 すばやく動く(走る) / 〈船が〉追い風に乗って走る / 〈U〉《しばしばA~》すばやく動くこと,疾走 / 〈U〉風に吹かれて飛ぶ雲 / 〈C〉《しばしば複数形で》風まじりの激しい雨 
scum	 〈U〉(沸騰などの際に液体の表面にできる)浮きあわ,薄皮;(池などの水面の)浮きごみ,浮きあか / 《集合的に》人間のくず;〈C〉(個々の人間を指して)くず / 浮きあわ(浮きごみ)ができる 
scut	 (ウサギ・シカなどの)短い尾 
seal	 〈C〉アザラシ / 〈U〉アザラシの皮;アザラシのなめし皮 / アザラシ狩りをする 
seam	 (服などの)『縫い目』,(れんが・板などの)合わせ目,継ぎ目 / 縫い目のようなひび(しわ,割れ目,手術あとなど) / (岩石などの)薄層《+『of』+『名』》 / …‘を'縫い合わせる;…‘を'継ぎ合わせる / 《通例受動態で》…‘に'(切り傷,きざみ目など)をつける《+『名』+『with』+『名』》 / ひびがはいる,割れ目ができる;しわが寄る
sear	 (治療のため)〈傷口〉‘を'焼く;…‘を'やけどする;〈肉など〉‘を'焼く,あぶる / 〈植物〉‘を'枯らす,しなびさせる / …‘を'無感覚にする,〈心など〉‘を'固くする / =sere
seat	 『腰掛け』 / 『座席』,席 / (腰掛けの)腰をおろす部分;(体・ズボン・パンツの)しりの部分,しり / (権威の)座,地位,身分;(議会における)議席《+『in』+『名』》 / (…の)予約席《+『for』+『名』》 / (…の)所在地,ありか,中心地《+『of』+『名』》 / (馬・自転車などの)乗り方 / 《しばしば受動態で》〈人〉‘を'『着席させる』 / 〈ある数〉‘の'座席がある / 〈部品など〉‘を'固定する,すえつける
sect	 宗派,教派;(一般に)派 
sego	 セゴユリ(米西部産のユリの一種,球根は食用;Utah州の州花) 
self	 (他人と区別して)『自己』,自分,自身 / 〈C〉(人・物の)本質,個性;性格の一面 / 〈U〉私利,私欲,私心 / 同じ材料でできた,共ぎれの
send	 〈物〉‘を'『送る』,届ける;〈人〉‘を'『行かせる』,派遣する / (ある状態に)〈人〉‘を'送りこむ,させる / (…へ)〈弾丸・球・一撃など〉‘を'放つ,送りこむ《+『名』+『to』(『into』)+『名』》 / 〈音・光・手紙・人など〉‘を'出す,送り出す《+『forth』(『off, out』)+『名』》 / 人をやる,使いを送る / 手紙をやる,便りをする
sent	 sendの過去・過去分詞 
sera	 serumの複数形 
serf	 (昔のヨーロッパで)農奴 / 奴隷[のような人]
sewn	 sewの過去分詞 
sexy	 性に関する;セクシーな,性的魅力のある 
shad	 ニシン[の類] 
shag	 もじゃもじゃの毛 / (布地の)けば;けば立った布地 / 《英》安物の刻みたばこ 
sham	 〈C〉〈U〉にせもの,見せかけ,いんちき / 〈C〉ぺてん師,詐欺師 / 見せかけの,にせの / …‘と'見せかける,‘の'ふりをする / 見せかける;(…の)ふりをする《+『形』〈補〉》 
shed	 〈血・液など〉‘を'『流す』,こぼす / 〈葉・毛・外皮など〉‘を'『自然に落とす』;〈衣服〉‘を'脱ぐ / 〈光・香りなど〉‘を'放つ / 〈布などが〉〈水〉‘を'はじく,通さない / 〈動物などが〉脱毛する,脱皮する / 〈葉が〉落ちる
shew	 =show 
shim	 詰め物,かい物(物を水平にしたり,すき間に入れるくさび形の木片など) 
shin	 むこうずね / (動物の)すね,掌骨 / (両手・両足を使って)(…を)よじ登る《+『up』+『名』》 
ship	 (おもに大洋を航行する)船,大型船 / (船の)乗組員 / 《話》飛行機,飛行船;宇宙船 / シップ型帆船 / …‘を'『船で送る』,船に積む;(郵便・鉄道・トラック・飛行機などで)…‘を'『送る』,輸送する / 〈船が〉〈波〉‘を'かぶる / 〈船具〉‘を'船に取り付ける / 乗船する;船旅をする / (…として)船で働く,船員になる《+『as』+『名』》 
shit	 くそをする,大便をする / …‘を'大便をして汚す / くそ,大便;《しばしばa ~》くそをすること / たわごと / (怒り・嫌悪などを表して)ちぇっ,くそっ 
shod	 shoeの過去・過去分詞 / 靴をはいた
shoe	 『靴』;《英》短靴 / 靴形の物;(馬の)てい鉄(horseshoe);(杖・棒の)石突き;(自動車の)タイヤの外包み;(ブレーキの )輪止め;(そりの)すべり金 / …‘に'靴をはかせる;〈馬〉‘に'てい鉄を打つ / …‘の'先端(表面)に金具をつける
shop	 〈C〉《おもに英》『小売店』,『商店』(《米》store) / 《米》(百貨店などの中にある)小さい専門店 / 〈C〉(サービス業の)『店』 / 〈C〉『仕事場』,作業場 / (…で)『買物をする』《+『in』(『at』)+『名』》 / 《英俗》(人を)裏切る,密告する
shot	 shootの過去・過去分詞 
show	 〈物・姿・感情など〉‘を'『見せる』,示す / …‘を'『示して』(『説明して』)『教える』・…‘を'『明らかにする』,証明する;〈計騎などが〉…‘を'示す・《副詞[句]を伴って》〈人〉‘を'『案内する』,導く・…‘を'陳列する;…‘を'展示する;〈映画,劇など〉‘を'上映(上演)する / 見える,姿を見せる・(ある状態に)見える《+『形』〈補〉》(進行形にできない) ・《話》〈人が〉展示会(展覧会)を催す;商品を陳列する;〈映画・撃などが〉上映(上演)される・〈U〉《しばしばa show》『見せること』,表示・〈U〉《しばしばa show》見せかけ・〈U〉《しばしばa show》外観,様子;きざし / ・〈U〉《しばしばa show》見せびらかし,見え・C〉『展示会』,『展覧会』,品評会・〈C〉『見せ物』,興行,ショー,芝居,映画;(ラジオ・テレビの)番組・〈U〉《しばしばa show》《話》機会,チャンス;見込み・〈U〉《しばしばa show》光景,ながめ・〈C〉《話》仕事;物,事
shun	 …‘を'『避ける』(avoid) 
shut	 (…に対して)〈ドア・窓など〉‘を'『閉める』,閉じる(close)《+『名』+『on』(『to』)+『名』》 / 〈本・ナイフなど〉‘を'『閉じる』,たたむ / (…の中に)…‘を'閉じ込める《+『名』+『in』(『into』)+『名』》;(…から)…‘を'締め出す《+『名』+『from』(『out of』)+『名』》・〈店・事業など〉‘を'閉じる,閉鎖する・(ドアなどに)〈指・服など〉‘を'はさむ《+『名』+『in』+『名』》・閉じる,閉まる 
sick	 (人が)『病気の』;(部屋などが)病人の[ための];(顔色などが)病気を示す(思わせる) / 《名詞的に》《the ~;複数扱い》病人 / 《補語にのみ用いて》《おもに英》(…で)むかついて,吐き気を催して,気分が悪い《+『at(『with』,『from』+『名』(do『ing』)》 / 《補語にのみ用いて》(…に)『うんざりして』,あきあきして,いや気がさして;(…に)しゃくにさわって,腹が立って《+『of』+『名』(do『ing』)》 / 《補語にのみ用いて》(…に)『がっかりして』,落胆して《+『at』(『about』)+『名』(do『ing』)》 / 《補語にのみ用いて》(…を)熱望して,こがれて《+『for』+『名』》 / 病的な,異常心理の;気味の悪い 
side	 (物体)『面』 / (物体の)『側面』,わき / (紙・レコードなど平らな物の)『面』 / (中心線・分離線から見た)『片側』 / (中心部分から見て)…『側』 / (人間・動物の体の右または左の)『側面』,(特に)横腹,わき腹 / 《単随形で》(人の)『そば』,わき / (物の)端,へり;(図形の)辺 / (競技・争いなどの一方の)『側』,味方 / (事柄の持っている)一面,局面 / (父方または母方の)血統,…方(かた) / 側部の,側面の,わきの / 側部(側面)からの(への) / 二次的な,従の / 〈建物など〉‘に'側面を付ける / (…に賛成の(反対の))側につく《+『with(against)』+『名』》
sift	 〈粉・砂・灰など〉‘を'『ふるいにかける』 / …‘を'入念に調べる / ふるい分けをする / (ふるい,すき間を通して)ぱらぱらと降りかかる / (…を)入念に調べる《+『through』+『名』》 
sigh	 (悲しみ・疲れ・安心などで)『ため息をつく』《+『with』+『名』》;(…を)嘆いてため息をつく《+『over』+『名』》 / 〈風などが〉ため息をつくような音を立てる / 《文》(…を)思って(あこがれて)ため息をつく《+『for(after)』+『名』》 / 『ため息』
sign	 (ある事実・状態・感情などの)『表れ』,印,気配,徴侯(indication);(…の)こん跡,計跡《+『of』+『名』》・『身ぶり』,手まね,合図 / 『標識』,看板 / (数学・音楽などの)記号 / (…の)『象徴』,シンボル(symbol)《+『of』+『名』》・《文》(…の)『前兆』,きざし《+『of』+『名』》・宮(きゅう)(黄道12区分の一つ) ・〈手紙・書類・作品など〉‘に'『署名する』・(…に)〈名前など〉‘を'書く《+『名』+『on』(『to』)+『名』》 / …‘を'雇う契約に署名する・…‘を'合図する,知らせる;…に合図する・署名する・契約書に署名して雇われる 
silk	 〈U〉『生糸』,絹糸 / 『絹織物』,絹布 / 〈C〉《しばしば複数形で》絹の衣服,絹物 / 〈C〉《複数形で》《米》競馬の騎手が着るはでな色の服 / 〈U〉トウモロコシの盲 / 《英》勅選弁護士 / 絹の,絹製の,絹のような 
silo	 サイロ(牛馬の飼料として牧草(silage)を貯蔵する普通円筒形の建物) / サイロ(ミサイルを格納し発射する地下設備)
silt	 (川底などの)沈泥 / 〈水路・港湾など〉‘を'沈泥でふさぐ《+『up』+『名,』+『名』+『up』》 / 〈水路・港湾などが〉沈泥でふさがる,詰まる《+『up』》 
sine	 (数学で)正弦,サイン(《略》『sin』) 
sing	 『歌う』;(…に)歌って聞かせる《+『to』(『for』)+『名』》;(楽器に合わせて)歌う《+『to』+『名』》・〈小鳥・虫などが〉『鳴く』,さえずる / 《文》(…を)詩(歌)にする,(詩(歌)を詠んで)賛美する《+『of』+『名』》・〈小川・風・弾丸・湯沸かし・耳などが〉歌うように鳴る・《米語》自白する;密告する・〈歌〉‘を'歌う・《副詞[句]を伴って》歌って…‘を'(…に)する・…‘を'唱える,詠唱する・《文》…‘を'詩(歌)にする,(詩(歌)に詠んで)賛美する・合唱の集い
sink	 (水平面下に)〈船・太陽などが〉『沈む』・(…に)『下降する』,落ちる《+『into』(『to』)+『名』》・『量』(『勢い』,『程度など』)『が減る』,弱まる,下がる・〈健康・士気・名声・地位などが〉悪化する,衰える,下がる・(…の状態に)次第に落ち込む,陥る《+『in』(『into』)+『名』(do『ing』)》・(…に)深く入る,しみ込む《+『in』(『into』)+『名』》・〈船など〉‘を'『沈める』・…‘の'水平面の高さを下げる,‘を'低くする・(…まで)…‘の'『量(勢い,程度)を減らす』,‘を'弱める《+『名』+『to』+『名』》・〈井戸・穴など〉‘を'掘る・(…に)…‘を'沈み込ませる《+『名』+『in』(『into』)+『名』》・(…に)〈資本・労力など〉‘を'投ずる《+『名』+『in』(『into』)+『名』》 / …‘を'隠す;…‘を'無視する・《話》《しばしば受動態で》…‘を'だめにする,滅ぼす;失う・(バスケットボールで)〈球〉‘を'バスケットに入れる・(ゴルフで)〈球〉‘を'ホールに入れる・(台所・洗濯場・洗面所などの)『流し』・《米》洗面器(washbasin, washbowl) ・下水溝,下水だめ
sion	 =zion 
sire	 《S-》《冠詞なしで》《古》(国王などに対する呼び掛けで)陛下・〈C〉(動物,特に馬の)雄親 / 〈種馬が〉…‘を'生む
site	 (町・建物などの)『場所』;敷地,用地 / 遺跡;(事件などの)現場 / 〈建物など〉‘を'位置させる(locate) 
size	 〈U〉〈C〉(人や物の)『大きさ』 / 〈U〉大きいこと / 〈U〉数量,規模 / 〈C〉(帽子・靴・シャツなどの)『サイズ』,『寸法』,型 / 〈U〉《話》実情,真相 / …‘を'大きさ(寸法)によって分類する / …‘を'ある寸法に作る 
skag	 ヘロイン(heroin) 
skew	 斜めの,ゆがんだ / 傾斜,ゆがみ / …‘を'斜めにする,曲解する / それる,曲がる
skid	 (車・車輪などの)横滑り;スリップ / (坂を下るときの)車の歯止め,滑り止め / 《複数形で》(重いものを上に載せて滑らせる)滑り材;下敷き支材,枕木 / 〈人〉を急がせる / 〈自動車などが〉横滑りする,スリップする / …に滑り止めを掛ける;…‘を'滑り材の上に置く(の上を滑らせる)
skim	 〈液体〉‘から'『上澄みを取る』,浮遊物をすくい取る / (液体から)〈浮遊物〉‘を'『すくい取る』,〈上澄み〉‘を'取る《+『名』+『from』(『off』)+『名』》 / …‘を'『ざっと読む』 / 〈水面など〉‘を'『滑るように進む』,かすめて飛ぶ;(水面などすれすれに)…‘を'飛ばす(skip) / 《副詞[句]を伴って》『滑るように進む』,かすめて飛ぶ / (…を)ざっと読む《+『through』(over)+『名』(do『ing』)》 / (牛乳が)脱脂の(skimmed) 
skin	 〈U〉〈C〉(人・動物の)『皮膚』,肌 / 〈C〉〈U〉(動物からはいだ)『皮』,『毛皮』;皮製品,皮袋 / 〈C〉(果物・野菜の)皮 / 〈U〉〈C〉(液体の表面にできる)薄い膜,上皮 / 〈C〉(枠組み・表面などを覆う)外皮,外被,外板 / 〈動物・果物など〉‘の'皮をはぐ(むく) / 〈手・脚など〉‘を'擦りむく / 《話》(金などを)〈人〉‘から'巻き上げる《+『名』〈人〉+『of』+『名』》 / 〈傷口などが〉皮で覆われる《+『over』》 
skip	 《副詞[句]を伴って》『軽く』(ぴょんぴょん)『跳ねる』,ぴょんと跳ぶ / 《英》なわ跳びをする / 《副詞[句]を伴って》(論点などが)飛ぶ,移る / 『省く』,抜かす,飛ばして読む(話す,書く);(…を)省く《+『over』(『through』)+『名』》 / (…の)表面をはずみながら(かすめて)飛ぶ《+『along』(『over』)+『名』》 / 《話》急いでそっと立ち去る《+『off』(『out』)》 / …‘を'『軽く跳び越える』 / …‘を'『省く』,抜かす,飛ばして読む(話す,書く) / …‘を'休む,…‘に'出席しない / 〈石など〉‘を'水面をはずませながら(かすめて)飛ばす(skim) / 《話》〈ある場所〉‘を'急いでそっと立ち去る / 軽く跳ぶ(はねる)こと / 省略すること,飛ばすこと 
skit	 (…の)風刺的なお笑い寸劇《+『on』(『upon』)+『名』(『wh-節・句』)》 
skua	 オオトウゾクカモメ(北大西洋産の海鳥) 
slab	 (木材・石・金属の)厚板,平板;(肉・パン・ケーキ・チ・ズなどの)平たい厚切り 
slag	 のろ,鉱滓(こうさい),スラグ 
slam	 〈戸・窓など〉‘を'『ピシャリ(バタン)と閉める』 / 《副詞[句]を伴って》…‘を'『ドシン(ドン)ト置く』 / (新聞用語で)…‘を'けなす,攻撃する / 〈戸・窓などが〉ピシャリ(バタン)と閉まる / ドシン(ドン)とぶつかる(動く) / 荒っぽく音を立てて戸を閉めること;ピシャリ(バタン,ドシン)という音
slap	 『平手打ち』,平たい物で打つこと / (平手打ちなどの)ピシャリという音 / …‘を'『平手でビシャリと打つ』;…‘の'(…を)平手打ちする《+『名』+『in』(『on』)+『名』》 / (…に)…‘を'すばやく(ぞんざいに,むぞうさに)置く《+『名』+『on』+『名』》 / ピシャリと音を立てて打つ / まっすぐに,まともに
slat	 (木・金属などの)細長い薄板 
slaw	 《おもに米》=coleslaw 
slay	 (乱暴な方法で)…‘を'殺す,殺害する(《米》では,特に新聞用語としてkillの代りに普通に用いられる.《英》では《文》または戯言的にのみ用いられる) 
sled	 (また《英》『sledge』)『小型そり』 / 《米》=sledge1 / …‘を'小型そりで運ぶ / 小型そりに乗る
slew	 slayの過去 
slid	 slideの過去・過去分詞 
slim	 (体格などが)ほっそりとした,細い / (量・程度などが)わずかの,少しの(slight) / 〈体,体の一部分〉‘を'細くする / (減食・運動などで)体重を減らしてやせる《+『down』》
slip	 《副詞[句]を伴って》『滑る』,つるっと滑る・《副詞[句]を伴って》こっそり動く,滑るように動く・〈時が〉いつの間にか過ぎ去る《+『by』(『away,』『along,』『on』)》・(服などを)すばやく着る《+『into』+『名』》,するっと脱ぐ《+『out』『of』+『名』》・〈物価・質などが〉だんだん下がる,ずり落ちる・ちよっと間違いをする《+『up』『in』(『on』)+『名』》 / (心・記憶などから)〈物事が〉消え去る《+『from』(『out』『of』)+『名』》・〈物〉‘を'滑らせる;(…に)…‘を'滑り込ませる《+『名』+『into』+『名』》;(…から)…‘を'すっと出す《+『名』+『out』『of』(『from』)+『名』》・《『slip』+『名』〈間〉+『名』〈直〉=『slip』+『名』+『to』+『名』》…に…‘を'そっと渡す,こっそりやる・〈服など〉‘を'するっと着る《+『on』+『名,』+『名』+『on』》;…‘を'するっと脱ぐ《+『off』+『名,』+『名』+『off』》・…‘から'するっとぬける,脱出する・〈結び目など〉‘を'解く,ほどく・〈物事が〉〈心・記憶など〉‘から'消え去る,抜ける・『滑ること』,滑り;足を滑らせること・ちよっとした誤り,失策・(埠頭で)荷揚げ用斜面;修理用船台・スリップ(婦人用肌着) ・まくらカバー(pillowcase)
slit	 〈物〉‘を'切り開く,細長く切る(裂く) / 細長い切れ目,スリット(スカートなどの切り込み);細長いすきま(穴)
slob	 うす汚くだらしない人,無精でがさつな人 
sloe	 リンボク(サクラ属の低木;その黒い小さな果実) 
slog	 (特にクリケットで)〈ボール〉‘を'強打する / …‘に'精を出す / 強打する / こつこつ働く,精を出す / 〈C〉(クリケットでの)強打 / 〈U〉こつこつする仕事,苦しい道のり
slop	 〈U〉ぬかるみ / 〈C〉こぼれた水(食べ物);はね水 / 〈C〉まずい食べ物(飲み物);《複数形で》(病人用の)流動食 / 《しばしば複数形で》(豚などに与える)残飯 / 《複数形で》(排水設備のない台所などで,ためておく)洗い流し水,捨て水;(人の)排せつ物 / 〈液体が〉(…から)こぼれる,飛び散る《+『over』+『名』》 / ぬかるみをバチャバチャ歩く / 〈液体〉‘を'こぼす,はねかける
slot	 細長いみぞ(くぼみ,口);(自動販売器などの)料金投入口 / (リスト・予定表・ある組合せなどの中で占める)場所,位置 / …‘に'細長いみぞ(小穴)をつける / …‘を'区分けする,位置につける
slow	 (速度・動作などが)『遅い』,のろい / 《補語または名詞の後にのみ用いて》(時計などが)『遅れている』 / 『ゆったりした』,あわてない / (人が)理解の遅い,頭の鈍い / (生活・パーティーなどが)『活気のない』,おもしろくない / 遅く,ゆっくり(slowly) / 『遅くなる』,速度を落とす《+『down』(『up』)》 / …‘を'『遅くする』,‘の'速度を落とす《+『名』+『down』(『up』),+『down』(『up』)+『名』》
slue	 =slew
slug	 《米俗》弾丸,たま / (自動販売機などで不法に使われる)偽造硬貨
slum	 《しばしばthe slums》貧民くつ,貧民街,スラム / 《話》汚らしい場所 / (好奇心・慈善のために)貧民街を訪れる 
slur	 〈言葉など〉‘を'不明瞭(ふめいりょう)に発音する / 〈2つの音〉‘を'中断せずに演奏する(歌う) / 〈音符〉‘に'スラーをつける / 〈人〉‘を'けなす,悪く言う / (時間がなかったり隠そうとしたりして)…‘を'急いで片づける,あっさりと扱う《+『名』+『over,』+『over』+『名』》 / 不明瞭な発音[の話し方] / 中傷,悪口 / (音譜の)スラー;スラーのついた音符
slut	 不潔な女 / ふしだらな女
smog	 『スモッグ』,煙務 
smug	 自己満足した,ひとりよがりの 
smut	 〈C〉(一片の)すす,ほこり;汚れ,しみ / 〈U〉わいせつな物(写真・文章など) / 〈U〉(麦の)黒穂病 / …‘を'汚す
snag	 (切り株・隠れた岩などの)鋭い(ごつごつした)突起 / (船の進行を妨げる)沈み木,倒れ木 / (衣類の)かぎ裂き,裂き目 / 《おもに英》意外な障害(故障) / …‘を'沈み木(切り株)に引っかける(からませる);(…に引っかけて)〈服〉‘を'かぎ裂きにした / 《米話》…‘を'すばやくつかまえる / 〈湖・河など〉‘の'沈み木を除去する 
snap	 『パチン』(『ポキン』,『カチッ』,『ピシッ』)『と音をたてる』・〈木の枝などが〉『ポキッと折れる』,〈糸などが〉プツンと切れる・〈戸・ふた・カギなどが〉パチン(カチッなど)と音をたてて(…の状態に)なる《+『形』〈補〉》・(…に)ぱくっとかみつく《+『at』+『名』》・…‘を'『パチン(ピシッ)と音をさせる』・…‘を'ポキッと折る,プツンと切る;…‘を'パチッと締める・〈命令・応答など〉‘を'ピシッと言う《+『out』+『名,』+『名』+『out』》・《話》〈スナップ写真〉‘を'撮る・〈C〉『ポキッと折れる音』,プツンと切れる音;ビシャッと閉まる音・〈C〉(衣服などの)『スナップ』,留め金 / 〈C〉ぱっと飛びつくこと(かみつくこと,ひっつかむこと) ・〈C〉(急に襲う)一時の寒気・〈C〉(薄くてぱりぱりとした)ショウガ入りクッキー・=snapshot・〈U〉《話》活気,精力・〈C〉《単数形で》《話》容易なこと,楽な仕事・《話》即座の,急になされた・《話》容易な,楽な・どんぴしゃり,バッチリ
snip	 (…から)…‘を'はさみでちょきんと切る,はさみで切り取る《+『名』+『off』(『off of』)+『名』》 / (…を)ちょきんと切る《+『at』+『名』》 / ちょきんと切ること(音) / (またsnipping)切れ端;小片,少し / 《英話》掘出し物,買い得品,格安物 
snob	 物事を鼻にかける人(ひけらかす人);地位(財産)崇拝者 
snog	 キスする,愛撫する / キス,愛撫
snot	 鼻水 
snow	 〈U〉『雪』 / 〈C〉《単数形で》『降雪』;《複数形で》積雪 / 〈U〉〈C〉雪のような物;(特に)コカイン,ヘロイン / 《itを主語にして》『雪が降る』 / (…に)雪のように降る《+『on』+『名』》;雪のように舞い込む《+『in』》 / …‘を'雪のように降らせる / …‘を'雪でおおう(閉じ込める)《+『名』+『in』(『under, up』)》 
snub	 (特に)〈目下の者〉‘を'冷淡に扱う;〈申し出〉‘を'すげなく拒絶する / 鼻であしらうこと,けんつく,冷遇 / しし麦の 
snug	 『居心地のよい』,気持ちのよい,気持ちよく暖かな / (衣類が)ちょうどよい大きさの / (収入などが)生活に事欠かない,十分な 
soak	 …‘を'『びしょぬれにする』,ぬらす・(…に)…‘を'『浸す』,つける《+『名』+『in』(『into, through』)+『名』》・〈水分・知識など〉‘を'『吸収する』《+『up』+『名』,+『名』+『up』》・〈汚れなど〉‘を'しみ出させる《+『out』+『名』,+『名』+『out』》・《話》〈人〉‘に'法外な値段をふっかける・(液体などに)『つかる』,浸る《+『in』(『into』)+『名』》 / (…に)〈液体が〉『しみる』《+『in』(『into, through』)+『名』》・ / 『浸すこと』,つけること;(水に)つかった状態,ずぶぬれ 
soap	 『石けん』 / =soap opera / …‘を'石けんで洗う 
soar	 〈ワシなどが〉『空高く飛ぶ』,舞い上がる / 〈山などが〉そびえ立つ,高くそびえる(進行形にできない) / 〈物価などが〉『急に上る』 / 〈希望・元気・想像力などが〉高まる
sock	 『短い靴下』,ソックス 
soda	 〈U〉『ソーダ』,炭酸ソーダ,重炭酸ソーダ 
sofa	 『長いす』,ソファー 
soft	 (押されて形を変えるほど)『柔らかい』 / (木材・金属などが,同種の中で比較的)『柔らかい』 / (斤ざわりの)なめらかな,すべすべした / (声・音が)穏やかな,低い,静かな / (見た目に)どぎつくない,落ち着いた / (天候・気候が)穏やかな,温和な / (心・言動が)優しい,もの柔らかな / (体または精神などが)軟弱な,虚弱な / (市況・相場が)弱気の,下がり気味の / (水が)軟性の / (水音が)軟音の / アルコール分を含まない / 柔らかに / 静かに
soil	 〈U〉(植物の成長に適する)『土』,土壌(どじょう) / 〈U〉(特殊な)土 / 〈U〉〈C〉《気取って》国,地方;《the~》土地,農地 
sold	 sellの過去・過去分詞 
sole	 足の裏 / 靴底 / 〈靴〉‘に'底をつける 
some	 《複数名詞または数えられない名詞を伴って》『いくらかの』,多少の,少しの・《複数名詞または数えられない名詞を伴って》『一部の』,中には[…もある],…である[ものもある] ・《単数普通名詞を伴って》『ある』…,何か[の],どこか[の] / 《数詞を伴って》『約』…,…くらいの,…ばかり・《数量を表す名詞を伴って》相当多い,かなりの・《話》たいした,相当な,なかなかの・『いくらか』,多少,少し,幾分・『ある人たち,あるもの』,[…する人]もある・いくらか,多少,少しは(somewhat) ・かなり,相当
song	 〈C〉『歌』,『歌曲』,唱歌 / 〈C〉〈U〉(歌うための)詩,詩歌 / 〈U〉歌うこと / 〈U〉〈C〉(鳥・小川などの)『歌うような声』(『音』)
soph	 =sophomore 
sore	 (傷・患部が)『痛い』,触って痛い / (人が)(けが・打ち身などで)『痛みを感じる』 / 《古》つらい,ひどい,痛ましい / 《名詞の前にのみ用いて》(精神的に)痛い,苦しい / 《米話》《補語にのみ用いて》感情を害する,怒って / (体の)痛いところ,傷,ただれ,はれもの / 心痛の種(原因) 
sort	 『種類』,部類(kind) / 性格,性質,タイプ / 《おもに英話》《単数形で》(ある)種類の人 / …‘を'分類する,区分けする;えり分ける,選び出す《+『名』+『out,』+『out』+『名』》
soul	 〈C〉〈U〉『魂』,霊魂;『心』,精神(spirit) / 〈U〉『情』,感情,情緒 / 〈U〉(物事の)生命,精髄;《話》生気,迫力 / 〈C〉『人』,人間 / 〈C〉(…の)権化,典型,化身《+『of』+『名』》 / 〈C〉(…の)指導者,中心人物《+『of』+『名』》 / 米国黒人[文化]の,米国黒人[文化]特有の,米国黒人[文化]に由来する 
soup	 『スープ』 
sour	 (酢・レモンのように)『すっぱい』 / 『発酵してすっぱい』 / (においなどが)不快な / よくない,まずい / 『気難しい』,不きげんな / (土地が)酸性の / …‘を'すっぱくする / …‘を'不きげんにする / すっぱくなる / 不きげんになる
sown	 sow(種子をまく)の過去分詞 
spam	 スパム(コンビーフに似た豚肉かん詰の商標名：アメリカ軍に占領された歴史の長い場所、例えば沖縄・ハワイ・フィリピンなど、で郷土料理に採り入れられることが多い)・迷惑メール・迷惑メールを送る 
span	 『スパン』,親指と小指を広げた長さ(約9インチ=23センチ) / (ものが及ぶ限りの)長さ,伸び,範囲 / (アーチ・はり・橋などの)支柱間の距離,径間,渡間(わたりま)・『短い期間』,つかの間 / (親指と小指を広げて)…‘を'測る / 〈橋・道路などが〉〈川・土地など〉‘に'架(か)かる,‘を'横切る,‘に'伸びる / 〈川・土地など〉‘に'(橋・道路などを)架ける,渡す《+『名』+『with』+『名』》 / (空間・時間的に)…‘に'及ぶ,わたる 
spar	 (戸船の帆柱・帆げたなどの)円材 
spat	 スパッツ(くるぶしの少し上まである短いゲートル) 
spay	 〈動物〉‘の'卵巣を除去する 
spec	 投機 
sped	 speedの過去・過去分詞 
spew	 〈水・煙など〉‘を'噴出する / 《俗》〈へどなど〉‘を'吐く(vomit) / 〈水・煙などが〉噴出する / 《俗》へどを吐く
spin	 (羊毛などから)〈糸など〉‘を'『紡ぐ』《+『名』+『out of』+『名』〈羊毛〉》,(糸などに)〈羊毛など〉‘を'紡ぐ《+『名』〈羊毛〉+『into』+『名』》 / 〈クモ・カイコなどが〉〈糸〉‘を'『吐く』;〈巣・繭〉‘を'かける / …‘を'くるくる回す / 〈物語など〉‘を'作る,話す / 『糸を紡ぐ』;〈クモ・カイコなどが〉糸を吐く / 〈こまなどが〉くるくる回る / 〈車などが〉疾走する / 〈頭などが〉くらくらする / 〈C〉〈U〉くるくる回すこと;回転 / 〈C〉《単数形で》(車などの)一走り / 〈C〉(飛行機の)きりもみ降下 / 〈C〉《単数形で》(価値などの)急落
spit	 〈つば・食べ物など〉‘を'『吐く』,吐き出す《+『out』+『名』,+『名』+『out』》 / (…に)〈悪口など〉‘を'吐き出すように言う《+『out』+『名』+『at』+『名』》 / (…に向かって)『つばを吐く』《+『at』(『in』,『into』,『on』,『upon』)+『名』》 / つば(saliva)
spot	 『斑点』(はんてん),まだら,ぶち;(太陽の)黒点 / 『しみ』,よごれ;吹出物,にきび / (…に対する)汚名,汚点《+『on』+『名』》 / 『場所』,地点;部分,箇所 / (順序・組織における)位置;立場,おかれた状況 / 《a spot》《英話》(…の)少量,ちょっぴり(の…);(…の)1杯《+『of』+『名』》 / (ラジオ・テレビ番組の)構成区分 / …‘を'『しみで汚す』,‘に'汚れをつける;…‘に'斑点(はんてん)をつける,‘を'まだら(ぶち)にする;( …で)…‘に'しみ(斑点)をつける《+『名』+『with』+『名』》 / 〈人格・名声など〉‘を'汚す,傷つける / (特定の場所に)…‘を'置く,配置する / …‘を'見つける;(…だと)…‘を'見抜く《+『名』+『as』(『for』)+『名』》 / 〈インクなどが〉『しみになる』;〈布などが〉汚れる / 即座になされる,即時払いの(引き渡しの) / 現場での,現地の / (ラジオ・テレビで)番組の間に放送される / ちょうど,ぴったり(exactly)
spry	 活発な,元気の良い 
spud	 (除草用の)小すき / 《話》ジャガイモ(potato)
spun	 spinの過去・過去分詞 
spur	 『拍車』 / (…に対する)『刺激』,激励《+『to』(『for』)+『名』》 / 拍車状のもの,(鶏などの)けづめ,(植物の)距(きょ) / (山などの)支脈 / (行き止まり)支線 / 〈馬〉‘に'拍車を当てる《+『on』+『名』,+『名』+『on』》 / 〈人〉‘を'かり立てる:《『spur』+『名』+『to』(『into』)+『名』…に…をかり立てる》 
stab	 (刃物・とがったものなどで)…‘を'『刺す』,突き刺す《+『名』+『with』+『名』〈刃物など〉》 / (…に)〈刃物・とがったものなど〉‘を'突き刺す《+『名』〈刃物など〉+『into』+『名』》stab a fork into meatフォークを肉に突き刺す / (…まで)〈人・心など〉‘を'鋭く傷つける《+『名』〈人・心など〉+『to』+『名』》 / (…に)刃物で突きかかる,(…に)突き刺さる《+『at』+『名』》 / 『突き刺すこと』 / 刺し傷 / 刺すような鋭い痛み / 《話》(…に対する)試み,企て《+『at』+『名』(do『ing』)》
stag	 雄ジカ / 《米話》(社交的な集まりに)婦人を同伴しない男 / 男性用の,男性のみ出席する,男性向けの / 女性を同謀しないで
star	 『星』;恒(fixed star) / 『星形のもの』;星章,星標(*)(asterisk) / 『スター』,花形 / (人の運勢を左右するといわれる)運星;《しばしば複数形で》運勢,運,星回り / (星印で示した)等級 / 《文》実現不可能な逆標(願望) / 星の / 花形の,主役の;卓越した,すぐれた / …を星(星形の物)で飾る;…‘に'星印をつける;(…を)…‘に'のようにちりばめる《+『名』+『with』+『名』》 / …‘を'主役にする / 主役を務める,主演する 
stay	 《副詞[句]を伴って》『とどまる』,いる / (訪問者・客として)(…に)『滞在する』,泊まる《+『at』(『in』)+『名』〈場所〉,+『with』+『名』〈人〉》 / 『じっとしている』《stay+名(形,過分)〈補〉…のままでいる》 / …‘を'押しとどめる,引き止める / …‘の'間滞在する / 《おもに文》〈食欲など〉‘を'一時的にいやす(満たす) / 〈判決など〉‘を'延期する,猶予する / …‘を'最後までもちこたえる,がんばり通す《+『名』+『out』》 / 〈C〉《単数形で》『滞在』,とう留 / 〈C〉〈U〉停止,休止 / 〈C〉〈U〉(執行などの)猶予,停止 
stem	 (草の)『茎』,(木の)『幹』 / 葉柄,花梗(かこう) / 『茎状のもの』;(杯・グラスの)『脚』,(パイプ・さじの)柄,(時計の)りゅうず / (単語の)語幹,語根 / 船首;船首材 / …‘の'茎(軸)を取り去る,へたをとる / (…から)生じる,(…に)由来する《+『from』+『名』(do『ing』)》 
step	 『一歩』,歩み;一歩の距離,歩幅;短い距離 / (階段・はしごの)『段』,踏み段;《複数形で》『階段』 / (目的・目標への)『一歩』,一段階《+『to』(『toward』)+『名』》 / 足音 / 足跡 / 『歩調』,足取り;(ダンスの)ステップ / (目標に近づく)『手段』,方法,処置 / 階級,昇級 / (音楽で)音程 / (温度計などの)目盛り / 《方向を表す副詞[句]を伴って》(…の方へ)『歩む』,一歩踏み出す,行く / (…を)踏みつける《+『on』+『名』》 / 〈足〉‘を'踏み出す;〈ダンス〉‘の'ステップを踏む / …‘を'歩測する《+『off』(『out』)+『名』,+『名』+『off』(『out』)》 / 〈段〉‘を'切り込む 
stew	 〈食物〉‘を'『とろ火で煮る』,シチューにする / 《話》…‘の'気をもませる,‘を'いらいらさせる / とろとろに煮える,シチューになる / 《話》やきもきする,気をもむ / 〈C〉〈U〉『シチュー』(肉・野菜などをとろ火で煮込んだ料理) / 〈C〉《話》気をもむこと
stir	 …‘を'『かき混ぜる』,かき回す;…‘を'(…に入れて)かき混ぜる《+『名』+『into』+『名』》 / 〈物事〉‘を'『かき立てる』;…‘を'扇動する《+『up』+『名,』+『名』+『up』》 / 〈人〉‘を'奮起させる,‘の'心をかき立てる《+『up』+『名,』+『名』+『up』》 / 《話》…‘の'目を覚まさせる《+『up』+『名』》 / …‘を'軽く動かす / (特に,かすかに)『動く』 / 《話》動き回る,起きて働く;目を覚ます / かき回せる,かき混ぜられる / 〈U〉《しばしばa ~》騒ぎ / 〈C〉《a ~》かすかな動き / 〈C〉(スプーンなどで)かき混ぜること 
stop	 〈動いているもの〉‘を'『止める』 / 〈供給など〉‘を'停止する / …‘を'阻止する,やめさせる / 〈自分がしていること〉‘を'『やめる』,中断する / 〈穴・口など〉‘を'ふさぐ,〈びんなど〉‘に'せんをする / 〈相手の一撃など〉‘を'かわす;〈相手〉‘を'打ち負かす,ノックアウトする / 〈楽器の弦・穴〉‘を'指で押さえる,〈音〉‘を'指で押さえて出す / 〈動いているものが〉『止まる』,停止する,立ち止まる / 〈仕事・話などが〉『中断する』;〈雨などが〉やむ / 〈人が〉仕事(話など)をやめる,手を休める,一息つく / 《話》(…に)滞在する,とどまる《+『at』+『名』〈場所〉『,』+『with』+『名』〈人〉》 / 『止まること』,停止,中止,中断 / (旅先での)短期間の滞在,立ち寄り / (道路の)停留所 / (穴などを)ふさぐこと…(びんなどの)せん / (パイプオルガンなどの)ストップ,音栓(肝先) / 句読点,(特に)終止符 / (レンズの)絞り / 閉鎖音([p][b][k]など) 
stow	 (場所・入れ物に)…‘を'しまい込む,詰め込む《+『away』+『名』+『in』(『into』)+『名』》 / (…を)〈場所・入れ物〉‘に'しまう,詰め込む《+『名』+『with』+『名』》
stub	 (鉛筆・たばこなどの)使い残り;短い切れ端,(木の)切り株 / (小切手帳などの)控え;《米》(入場券などの)半券 / (…に)〈つま先〉‘を'ぶつける《+名+against+名》 
stud	 《おもに米》種馬 / 《集合的に》(一群の)繁殖用動物(種馬,種牛など)
stun	 (殴打などで)…‘を'気絶させる / (驚き・時に喜びなどで)〈人〉‘の'肝をつぶさせる,‘を'ぼう然とさせる(amaze)
such	 《特定の種類・程度を示して》『こんな』,あんな / 《類似の種類・程度を示して》『そんな』,そのような / 《名詞の前にのみ用いて,強意的に》『とても』(良い,悪い,ひどい) / 《補語にのみ用いて》『そのような』 / そのような人(物,事) 
suck	 (…から)〈ミルクなど〉‘を'『吸う』,すする《+名+from(out of)+名》 / …‘の'汁を吸う(すする) / (口の中で)…‘を'『しゃぶる』,なめる / (一般に)…‘を'吸い込む,吸い取る《+in(up)+名》 / (…を)吸う《+at+名》 / 乳を吸う / 吸うこと,吸収 ・フェラチオをする・価値がない、最低だ、最悪だ、ひどくいやったらしい、むかつくほどだ、不快だ、不十分だ、低品質｛てい ひんしつ｝だ 　 ・ That company sucks. : あの会社は最低だ。 ・ You suck. : あんた最低ね。
suet	 スエット(牛や羊の腎臓のあたりの脂肪;料理や獣脂製造に用いる) 
suit	 〈C〉『スーツ』 / 〈C〉《複合語を作って》(…用の)服 / 〈C〉『訴訟,』告訴(lawsuit) / 〈C〉(カードゲームで)同種のカードの一組;同種のカードの持ち札 / 〈U〉〈C〉嘆願,懇願 / 〈U〉《古》求愛,求婚;嘆願 / 〈C〉(…の)一組,一そろい《+of+名》 / …‘に'『適する,』合う / 《しばしば受動遠で》(…に)…‘を'合わせる,適応させる / 〈人〉‘に'『似合う』 / 〈人〉‘に'都合がよい,‘を'満足させる / 適する,合う / 似合う / 都合がよい
sulk	 すねる,ふくれる / すねること,不きげん,ふくれっつら
sump	 水などを集める穴;汚水だめ / (坑底の)水だめ,集水坑 / (エンジンなどを)油だめ,油つぼ / 《英》=crankcase
sung	 sing の過去分詞 
sunk	 sink の過去分詞 
surd	 無理数(ルート3など) 
sure	 《補語にのみ用いて》(人が)『確信して』,自信をもって / 《補語にのみ用いて》(物事が)『確実な』 / (修事が)『確固とした』,確実な / (人が)『信頼のおける』,安心のできる / 確かに,全く / (返答で)いいとも,もちろん(certainly)
surf	 (海岸・岩に砕ける)寄せ波,岸打つ波 / (砕ける波の)白いあわ / 波乗りをする,サーフィンする / 投げ釣りの
surg	 surgeon / surgery / surgical 
swab	 棒ぞうきん,モップ / (治療用・塗布用の)消毒綿;綿棒(耳かきなど) / …‘を'モップで掃除する / (薬などを)…‘に'綿棒で塗る
swag	 《俗》略奮品,盗品 / 《オーストラリア》(放浪者の持ち歩く)身の回り品一式の入った壁み
swam	 swimの過去 
swan	 『ハクチョウ』(白鳥),スワン / 《the S-》白鳥座
swap	 《単数形で》(物と物の)交換,取り換え;交換物 / (と)…‘を'交換する《+名+for+名》 / 交換する 
swat	 …をぴしゃりと打つ / (…を)ぴしゃりと打つ《+at+名》 / (…を)ぴしゃりと打つこと《+at+名》 
sway	 『前後(左右)に動く,』揺れる / 《方向を表す副詞[句]を伴って》(一方に)『傾く,』かしぐ / …‘を'『揺する,』揺り動かす / (方向を表す副詞[句]を伴って)…‘を'傾ける / …‘に'『影響を与える,』‘を'左右する;《古》…‘を'支配する / (…の)揺れ,動揺《+of+名》 / (…の)影響;支配,統治《+of+名》 
swig	 (…の)がぶ飲み,痛飲・〈ビールなど〉‘を'痛飲する,がぶがぶ飲む / 痛飲する,がぶがぶ飲む
swim	 『泳ぐ』,水泳をする / (水上・空中などに)浮かぶ / (水などの易体で)いっぱいになる,あふれる《+with+名》・(…に)浸る《+in+名》 / 〈物ず〉ぐるぐる回るように見える;〈頭などが〉くらくらする / 〈河など〉‘を'泳いで渡る,〈ある距離〉‘を'泳ぐ / 《副詞[句]を伴って》〈人など〉‘を'泳がせる;〈船〉‘を'浮かせる / 『泳ぐこと』, 
swiz	 失望;詐欺,ぺてん 
swob	 swab 
swop	 =swap 
swot	 〈C〉《英話》がり勉家,猛勉強家(《米》grind) / 〈U〉がり勉 / がり勉する / (試験前に)…‘を'詰め込みで勉強する《+up+名,+名+up》
swum	 swim の過去分詞 
tabu	 =taboo 
tach	 =tachometer 
tack	 〈C〉(頭部の平たい)びょう・〈C〉〈U〉(風の向きと帆の位置で決まる)船の針路 / 〈C〉(帆の位置を変えて行う)針路変更 / 〈C〉〈U〉方針,やり方 / 〈C〉(裁縫の)しつけ,仮縫い / …‘を'びょうで留める《+down+名,+名+down》 / (…に)…‘を'付け加える《+名+on(onto)+名》 / …‘を'仮縫いする / (風上に向けて)〈船〉‘の'針路を変える;〈船〉‘を'ジグザグに進ませる / (船の)針路を変える;ジグザグに進む 
taco	 タコス(メキシコ料理の一種で,肉・チーズなどを包んで油で揚げたパンケーキ) 
tail	 〈C〉『尾』,しっぽ / 〈C〉『尾に似た物』;(飛行機・車の)尾部 / 〈C〉(…の)『後部』,末端,終り(底)の部分《+of+名》 / 〈C〉コインの裏側 / 《複数形で》燕尾(えんび)服(tail coat) / 〈C〉《俗》しり,けつ / 〈C〉《俗》尾行者 / …‘に'尾をつける / 《話》〈人〉‘を'尾行する / 〈物・音が〉しだいに減ってゆく,消えてゆく《+away(off, out)》
take	 …‘を'『手に取る』,つかむ,握る / (…から)…‘を'(力づくで)『取り上げる』,奪い取る,占領する《+名+from+名》・〈人〉‘を'『捕らえる』,〈魚・獲物〉‘を'捕獲する・(いくつかある物の中から)…‘を'『選んで取る』,選ぶ・〈賞など〉‘を'『勝ち取る』;〈試合〉‘に'勝つ・〈贈り物・金など〉‘を'『受け取る』,もらう・〈忠告など〉‘を'受け入れる,に従う;〈非難など〉‘を'甘受する・《副詞[句]を伴って》(…な気持ちで)…‘を'受け取る,‘に'反応する・〈人〉‘を'迎える,預かる,引き受ける;〈婿など〉‘を'とる・…‘を'予約する,借り入れる:(定期的に)…‘を'購読する,購入する・(元となるものから)…‘を'取ってくる,(本などから)…‘を'引用する《+名+from+名》・(体内に)…‘を'『取り入れる』,食べる飲む;〈休日など〉‘を'取る・〈外力・影響〉‘を'受ける;〈病気〉‘に'かかる:〈色〉‘に'染まる;〈におい〉‘が'移る;〈火〉‘が'付く・〈物〉‘を'『持って行く』,〈人〉‘を'『連れて行く』・…‘を'連れ去る;〈人の命〉‘を'奪う・(…から)…‘を'減じる,引く《+名+from(off)+名》・(…で)〈人〉‘の'心を奪う,〈注意など〉‘を'引く《+名+with+名》・(…へ)〈乗り物が〉…‘を'『運ぶ』,〈道などが〉…‘を'導く,〈仕事などが〉…‘を'行かせる《+名+to(into)+名》・〈乗り物〉‘に'『乗る』・〈物事が〉・〈時間・空間・労力など〉‘を'『必要とする』,要する・〈人が〉〈場所・位置〉‘を'『占める』・《動作を表す名詞を目的語にして》〈その名詞が表す行動・動作など〉‘を'『する』,とる,実行する・〈手段〉‘を'とる;〈道具など〉‘を'用いる・〈時間・機会など〉‘を'利用する・〈授業〉‘を'受ける・〈道〉‘を'行く,とる・…‘を'書き取る;〈絵画〉‘を'描く;〈写真〉‘を'撮る・…‘を'取り扱う,考慮する・責任・義務〉‘を'負う;〈役目・職務など〉‘に'就く・…‘を'計る,測定する;…‘を'調査する・〈ある感情・決意・見解など〉・‘を'持つ,抱く・…‘を'『理解する』,分かる・…‘に'当たる(hit) ・〈男が〉〈女〉‘と'性交する・〈機械装置などが〉かかる;〈歯車などが〉かみ合う・〈根が〉つく;〈種が〉芽を出す・〈薬が〉効く;〈接種が〉つく / 〈インキ・染料・絵の具などが〉付く,乗る / 人気を博す,受ける・《副詞[句]を伴って》写真に写る・(1回の)捕獲高,漁獲高 / (映画で,連続して撮った)1シーン;(連続撮影の)1ショット・反応・見解：「What is your take on何々?」で「何々をどう思いますか」 
talc	 滑石,タルク(柔らかですべすべした鉱物) 
tale	 (事実・伝説・架空の)『話』,物語 / 作り話,うそ / 《複数形で》告げ口,中傷 
tali	 talus の複数形 
talk	 『話す』,しゃべる,物を言う,口を利く / (考えなどを伝えるために)(…と…について)『語る』,話す,話し合う,論ずる《+to(with)+名+about(of, on)+名(doing, wh-節・句)》 / うわさ話をする;秘密をもらす / (言語以外の方法で)話す,合図する / …‘を'ことを話す,‘を'論ずる / 〈言語・方言〉‘を'話す,使う / 〈人〉‘に'話す / 〈C〉『話』,談話,おしゃべり;《複数形で》(正式な)『話し合い』,協議 / 〈C〉(…についての)(形式ばらない)『演説』,講演《+on(about)+名》 / 〈U〉うわさ,風説;《the~》うわさの種 / 〈U〉空論,むだ話 / 〈U〉話しぶり,口調
tame	 (動物が)『飼いならされた』,人になれた / (人・動物が)『おとなしい』, / 《話》おもしろくない,退屈な,つまらない / 〈野獣など〉‘を'『飼いならす,』(飼いならして)おとなしくさせる / …‘を'制御する,制御して利用する 
tamp	 (軽くたたいて)…‘を'詰める《+down+名,+名+down》 / (発破て)〈爆薬を詰めた口〉‘を'泥でふさぐ
tang	 (…の)ぴりっとした味,ぶんとくるにおい《+of+名》 
tank	 (液体・ガスなどを入れる)タンク / 『戦車』,タンク / …‘を'タンクに蓄える 
tape	 〈U〉(細長い紙・布などの荷造り用)『テープ』,ひも / 〈C〉(決勝線用の)テープ / =tape measure / 〈C〉〈U〉録音用テープ / =tape recording / =tape measure / …‘を'テープをくくる,テープをくっつける / =tape-record / …‘を'巻き尺で測る / 《しばしば受動態で》《米》…‘に'包帯をする(《英》strap) / =tape-record 
tare	 カラスノエンドウ(牧草) / 《通例複数形で》有毒な雑草(新約聖書「マタイによる福音書」から)
tarn	 山中の小さな湖(池) 
taro	 タロイモ(南洋諸島のサトイモの一種) 
task	 (つらく骨の折れる)『仕事』,(課せられた)務め / 〈仕事などが〉…‘を'苦しめる,酷使する
taxi	 『タクシー』(taxicabの略) / タクシーで行く / 〈飛行機が〉(ゆっくりと地上・水上を)滑走する / 〈飛行機〉‘に'誘導滑走させる
teak	 チークの木(東インド産で材質を堅いので造船・家具に用いる);〈U〉チーク材 
teal	 マガモ・カルガモの類(飛ぶのが速い) 
team	 (スポーツの)『チーム』 / (共に仕事などをする)『一団』,一組 / (荷車を引く2頭以上の牛馬などの)一組 / 〈動物〉‘を'一組にする / …‘を'一組の動物で運ぶ / (…と)『チームを作る』,チームを組む,協力する《+up with+名》
tear	 …‘を'『裂く』,破る,引き裂く / 〈穴など〉‘を'『破って作る』 / (…から)…‘を'『引きはがす』,もぎ取る,引き離す《+away(down, off, out, up)+名+from(out of, off)+名》 / 《受動態》で…‘を'裂いて(破って)分ける《+名+apart》 / 裂ける,破れる / 《副詞[句]を伴って》激しく(大急ぎで)動く,突進する
tend	 〈人が〉(…の)『傾向がある』,(…)しがちである / 〈物事が〉(ある方向に)向かう,(ある状態に)向かう
term	 〈C〉『専門用語』,術語 / 〈C〉(一般に)語[句],言葉 / 《複数形で》言い方,言葉遣い / 〈C〉『期間』 / 〈C〉〈U〉『学期』 / 《複数形で》(人との)間柄,仲《+with+名》 / 《複数形で》(協定などの)『条件』;要求額,値段 / 〈C〉(数式で)項 / 《term+名〈目〉+名(形)〈補〉》(…と)…‘を'名づける,呼ぶ 
tern	 フジサシ(カモメに似た海鳥) 
than	 《比較級の後に用いて》…『より[も]』,に比べて / 《関係代名詞的に用いて》…『よりも』 / 《other,otherwise,else,different などの後に用いて》…より(ほかの,ほかに) / 《rather,sooner などの後に用いて》…『よりむしろ,』…するくらいなら / 《話》《hardly, scarcely の後に用いて》=when,before / 《文》《通例 than whom の形で》…より[も] / 《話》《比較級の後に用いて》…より,に比べて 
thaw	 〈氷・雪などが〉『解ける』《+『out』》 / 冷えた体が暖かくなる《+out》 / 《it を主語にして》暖かくなる,氷や雪が解ける気候になる / 〈人・態度などが〉打ち解ける,和らぐ / 〈氷・凍りついたものなど〉‘を'『解かす』 / (氷などが)解けること,雪解け / 雪葦けの季節,解氷期 / (心が)打ち解けること
them	 『彼らを(に)』,彼女らを(に),それらを(に) 
then	 『その時』,あの時,そのころ / (時間・場所・順番などが)『それから』,その次に,隣に,その[すぐ]後で / 『その上』,それに / 《通例文頭または文尾において》『それでは』,それなら,その結果 / 『その時の』,当時の / 『その時』
they	 『彼らが(は)』,彼女らが(は),それらが(は) / (一般に)『人々』,世間の人
thin	 『薄い』 / 細い / 『やせた』,やつれた / (液体・気体が)『薄い』,希薄な / まばらな,密集していない / 内容のない,見え透いた / (音・声が)『か細い』 / 薄く,細く,まばらに / …‘を'薄くする,細くする,まばらにする / 薄くなる,細くなる,まばらになる
this	 《近くの人・物・事を指して》『これ』,この人,こちら / 《時間・場所を指して》『今』,現在,今日;『ここ』 / 《次に述べること・今述べたことを指して》『このこと』,これ,こういうこと / 《that と対照的に》 / (that の前者に対して)『後者』 / 『この』 / 『今の』現在の;最近の / 《that と対照的に》『この』,こっちの / 《程度・量を示す形容詞・副詞とともに》これだけ,こんなに,この程度まで 
thou	 なんじ,そなた(you) 
thru	 =through 
thud	 ドザッ(ドシン)[という音] / ドザッ(ドシン)と響く
thug	 悪漢;人殺し 
thus	 『このように』,かくかくして / 『従って』,だから
tick	 (時計まどの)カチカチ[という音] / 《英語》瞬間 / 照合(点検)済みの印,チェック / <時計などが>カチカチ音がする《+away》 / <時が>過ぎる,経過する∥+by(away)》 / 《話》<人が>行動する,<機械などが>動く
tide	 〈U〉〈C〉『潮[の干満]』,(潮の干満によって起こる)潮流 / 〈C〉(世論などの)『風潮』,全体的傾向,形勢 / 〈C〉潮(のように押し寄せてくる…)《+of+名》 / 〈U〉《古》時,季節 / 《『tide over』+『名』》(困難・障害を)乗り切る / (難しい時期を)〈人〉を助けて乗り切らせる,‘に'なんとかやっていかせる《+名+over+名》
tidy	 『きちんとした』,整然とした;(人・動物などが)きれい好きな,自分をきれいにしている / 《話》かなりの / …‘を'きちんとする,整とんする《+名+up,+up+名》 / かたづける,整とんする《+up》
tier	 (ひな段式になった段々の)一段,一列 / …‘を'段段に積む,重ねる
tike	 tyke 
tile	 (床・壁用の)『タイル』;屋根がわら;《集合的に》タイル,かわら / (ドミノなどゲームの)こま,(マージャンの)牌 / (下水・煙突などの)土管,コンクリート管 / …‘に'タイルを張る;〈屋根〉‘を'かわらでふく
time	 〈U〉《冠詞をつけずに》(空間に対しての)『時間』,時 / 〈U〉(時計で示される)『時刻』 / 〈U〉(ある方式で決められる)『時間』,標準時 / 〈C〉〈U〉(特定の)『時』,おり,ころ / 〈U〉《しばしば A ~》(ある長さの)『時間』,期間 / 〈U〉(要する)『時間』;暇 / 《しばしば複数形で》(歴史上の)『時代』 / 《複数形で》時勢,景気 / 《one's ~》(個人の)一生;若いころ;生涯の特定の時期 / 〈U〉《しばしば A ~》(ある経験をした)『時間』 / 〈C〉『…回』,度 / 〈C〉『…倍』 / …の時間を定める / (…に)…の調子を合わせる《+名+to+名》 / …の時間を計る 
tine	 (くまで・フォーク・シカの角などの)鋭くとがった先 
ting	 …‘を'チリンチリナ(リンリン)と鳴らす / チリンチリン鳴る宴
tiny	 『とても小さい』,ちっぽけな 
tire	 〈人など〉‘を'『疲れさせる』,疲労させる / 〈人など〉‘を'『飽きさせる』,うんざりさせる / 疲れる / (…に)飽きる《+of+名(doing)》
tiro	 =tyro 
toad	 ヒキガェル,大形のカエル 
toed	 足指のある / 《複合語を作って》足指が…の:five-toed 足指が5本の
toga	 トーガ(古代ローマ市民の着たゆるやかな外衣) 
toil	 『骨折って(精を出して)働く』,(…を)精を出してする《+at+名(doing)》 / 骨折って進む《+along(on,over,through,up)+名》 / 『骨折り仕事』,苦労(類語) 
toke	 マリファナたばこの一服 / 〈マリファナたばこ〉‘を'吸う,‘に'火をつける
told	 tell の過去・過去分詞 
tomb	 『墓』(grave);(一般に)埋葬場所 
tome	 大冊,大著 
tone	 〈C〉(高さ・音色・長さ・音量の点から見た)『音』 / 〈C〉〈U〉音質 / 〈C〉楽音;全音程 / 〈C〉《しばしば複数形で》『言い方,書き方』,口調,語調 / 〈C〉支配的な(一般的な)風潮(傾向) / 〈U〉(筋肉などの緊張の)『正常な状態』 / 〈C〉『色調』,色合い,濃淡,明暗 / (音・色などで)…‘に'『ある調子(口調,色合い)をつける』 / …‘の'色を変える,色を補正する 
tong	 在米中国人の友愛団体 
tope	 酒びたりになる / 〈酒〉‘を'ひどく(常に)飲む
tops	 《補語にのみ用いて》《米話》最上の,最高の 
tore	 tear の過去 
torn	 tear の過去分詞 
tour	 (数か所に立ち寄る比較的長期の)(…の)『観光旅行』《+around(《英》round)(through,in,of)+名》・(特に,見学,観光などの)(…の)『小旅行』《+around(《英》round)(through,in,of)+名》・(劇団の)巡業,演奏旅行・(外地の一定の場所での)服務期間・…を旅行する・ / (…を)旅行する《+at(in,through,around(《英》round))+名》
town	 〈C〉町 / 《the~;一つの町を指して言うとき a~》(田舎と区別して)『都会』;都会生活 / 《冠詞をつけずに》都心,(商店の立ち並ぶ)下町 / 《冠詞をつけずに》(ある地域の)主要な町(市);(一国の)首都 / 《the~》《集合的に;単数扱い》町の人たち,町民 
trad	 トラッド(1920年代にニューオリンズに発生したジャズの一形式) 
tram	 《英》(また tramcar)=streetcar / 〈C〉(鉱山用の)四輪運搬車,トロッコ
trap	 (獲物をとる)『わな』 / (人を陥れる)わな,計略,策略 / 防臭弁(水をためて臭気を防ぐ排水管のUまたはS字刑の部分) / トラップ(クレイ射撃で標的の粘土のハトを飛ばす装置) / (犬の競走で)犬の飛び出し口 / 《おもに英》軽二輪馬車 / 《俗》口 / 《複数形で》打楽器[類] / 〈動物〉‘を'わなに掛ける / 〈人〉‘を'計略に掛ける,‘に'いっぱい食わせる / 〈ガス・液体など〉‘を'防臭弁で防ぐ;…‘を'ふさぐ,さえぎる / わなを仕掛ける
tray	 浅いへりのついた平たい容器,(料理などを運んだり盛ったりするための)『盆』,皿 / (机上書類用の)整理箱 / (また tearful)盆(皿)一杯[の量] 
trek	 長くつらい旅をする / 長くつらい旅
trey	 (カード・さいころで)3[の目];3点の札 
trig	 きちんとした,こぎれいな / 元気な,健康な
trim	 (切ったり刈ったりして)…‘の'『形を整える』,‘を'こぎれいにする,手入れする / 〈余分なものなど〉‘を'切り取る,摘み取る《+名+off,+off+名》 / (…で)…‘を'飾る,‘に'飾りを付ける《+名+with+名》 / (航行するために)〈帆〉‘を'調節する,適帆する / (積み荷などを整理して)〈船・飛行機など〉‘の'つり合いを取る / 《話》(スポーツなどで)…‘を'完全に負かす,徹底的にやっつける / 〈意見・方針など〉‘を'都合のよいように変える / …‘を'削除する,削減する / 〈U〉《しばしば》刈り(切り)整えること / 〈U〉『整頓』,整備;(心身の)良好な調子 / 〈U〉装飾;(衣服・ドア・窓などの)縁取り装飾,木造部;(自動車などの)内装,外装 / 『きちんとした』,整った,こぎれいな,均整のとれた
trio	 三ツ組,3人組 / 三重唱[曲,団],三重奏[曲,団]
trip	 (一般に)『旅行』,旅 / (用件での)出張,通勤 / つまずき,踏みはずし / 過ち,失策 / (機械の)掛けはずし装置 / 《俗》(麻薬の)陶酔感(幻覚症状)の間 / (…に)『つまずく』,よろめく《+over(on)+名》 / (…を)間違える,誤る,しくじる《+over(on)+名》 / 《副詞[句]を伴って》軽快な足どりで歩く / 《俗》(麻薬で) 幻覚症状に陥る《+out》 / …‘を'『つまずかせる』《+名+up,+up+名》 / 〈人〉‘を'失敗させる,しくじらせる;〈人〉‘の'揚げ足を取る,あら捜しをする《+名+up,+up+名》 / 〈止め金・クラッチなど〉‘を'急にはずす,はずして作動させる 
trod	 treadの過去・過去分詞 
trow	 =believe, think　信じる　思う 
true	 『ほんとうの』,真実の / 『本物の』,正真正銘の(real) / 『誠実な』,忠実な,忠誠な(faithful) / 心からの,うそ偽りのない / 寸分違わない,正確に一致する,適合する / 正当な,適正な,正しい(proper) / 間違いない,確実な / <機械・器具などが>正確にできた,正しい位置にある;<声などが>正しい調子の / うそをつかないで,正直に / 寸分違わないように,確実に / 先祖の型どおりに / …‘を'正しく調整する《+up+名,+名+up》
trug	 (庭園で)花・道具を入れるかご 
tsar	 =czar 
tuba	 チューバ(低音の大型金管楽器) 
tube	 (金属・ガラス・ゴムなどの)管,筒 / (絵の具・歯みがきなどの)チューブ / 《米》(列車・地下鉄の)トンネル / 《英》地下鉄(《米》subway) / (ラジオ・テレビなどの)真空管(vacuum tube) / (動植物の)管状器官
tuck	 《状態・方向を表す副詞[句]を伴って》(保護・安全などのために)…‘を'『押し込む』,つめ込む / 《状態・方向を表す副詞[句]を伴って》…[の端(すそ)]‘を'『差し込む』,折り込む / 〈衣服など〉‘に'縫いひだ(タック)をつける / 〈C〉(そで・すそなどの)縫いひだ,タック,上げ / 〈U〉《英》(学童などが食べる)食物,(特に)菓子類 / 〈U〉《米》元気,精力
tufa	 トゥファ(温泉などに沈殿した炭酸石灰から成る多孔質の石灰石) 
tuna	 〈C〉(また tunny)マグロ / (また tunny, tuna fish)マグロの肉
tune	 (音楽の)『曲』,節(ふし),メロディー(melody) / 〈楽器〉‘の'調子を合わせる,‘を'調律する《+up+名,+名+up》 / 〈エンジンなど〉‘を'調整する《+up+名,+名+up》 / (…に)〈受信機〉‘を'同調させる,‘の'波長を合わせる《+名+to+名》
turd	 《禁句》糞,くそ / 《俗》いやなやつ
turf	 芝土,芝地 / 〈C〉(移植用などに切り取った)芝土の一片 / 〈C〉(燃料用の)泥炭塊 / 《the ~》競馬場,競馬
turn	 …‘を'『回す』,回転させる / 〈角など〉‘を'『曲がる』,迂回(うかい)する / …‘を'『ひっくり返す』,裏返す / …‘の'『向きを変える』,‘を'方向転換させる / …‘を'向ける / …‘を'『変化させる』,変質(変色)させる / …‘を'行かせる,追い払う / 〈ある年齢・時刻・数量など〉‘を'越す,過ぎる / 《副詞[句]を伴って》…‘を'乱す,めちゃめちゃにする / 〈胃〉‘を'むかつかせる;〈心・頭など〉‘を'混乱させる,狂わせる / …‘を'折る,曲げる,ねじる;〈足首〉‘を'くじく / …‘に'丸みをつける;(旋盤・ろくろで)…‘を'作る / …‘を'きれいに形作る;〈文・曲など〉‘を'うまく作る / 〈商品・資金〉‘を'回転させる;〈利益〉‘を'あげる / 〈土・畑など〉‘を'掘り返す(plow) / (何かを軸・中心にして)『回る』,回転する / (…に)『進路を変える』;〈道路などが〉(…に)曲がる;折れる;〈風などが〉(…に)向きを変える《+to(toward)+名》 / 〈人が〉(…に向かって)ふり向く《+toward+名》,(…から)そらす《+from+名》 / 〈人が〉ころがる,寝込りを打つ / 〈物が〉さかさになる,裏返しになる / (…に)心(注意など)を向ける《+to+名》;(…から)心(注意など)をそらす《+from+名》 / 変わる,なる / 〈木の葉などが〉変色する;〈牛乳などが〉変質する,腐敗する / 〈胃が〉むかつく;〈心・頭が〉混乱する,変になる;〈頭が〉ふらつく / 〈パイプなどが〉曲がる,たわむ / 〈C〉『回転』,回ること / 〈C〉『方向転換』,曲がること,折り返し / 〈C〉曲がり目;曲がり角,折り返し点 / 〈C〉《a turn》(状況などの)変化,転機;《the turn》(…の)変り目,転換期《+of+名》 / 〈C〉『順番』,番 / 〈C〉《a turn》一回りの散歩(ドライブ);一仕事 / 〈C〉行い,行為 / 《a turn》言い回し,言葉遣い / 〈C〉(…の)性向,気質;素質,才能《+『for』+『名』(do『ing』)》 / 〈C〉形,格好 / 〈C〉《話》(めまい・吐き気などの)発作《+of+名》 / 〈C〉《話》ショック,はっとすること / 〈C〉必要,急場 / 〈C〉見方,解釈;くふう,ひねり(twist) / 〈C〉《おもに英》(寄席などの)出し物,演芸
tush	 ちぇっ(非難を苦む不満を表す) 
tusk	 (象などの)きば / きばのような歯(突出物) / …をきばで突く(掘り返す) 
twig	 『小枝』,細枝(branch よりさらに分かれた枝をいう) 
twin	 『双生児の一人』;《複数形で》双生児,ふたご / よく似た人(物)の片方;《複数形で》対 / ふたごの;対の / 〈ある都市〉‘を'(…と)姉妹関係にする《+名+with+名》
type	 〈C〉(…の)『型』,タイプ,類型,種類(kind)《+of+名》 / 〈C〉(その種類の特質を最もよく表している)『典型』,手本,模範《+of+名》 / 〈U〉《集合的に》活字;〈C〉(1個の)活字 / 〈U〉(印刷された)字体,活字 / 〈C〉(貨幣・メダルなどの)模様,図柄 / 〈C〉血液型(blood group) / …‘を'タイプに打つ / (…として)…‘を'分類する《+名+as+名(doing)》 / …‘の'型を決める / タイプライターを打つ
tyre	 =tire
tzar	 =czar 
ugly	 (外見・容ぼうが)『醜い』,ぶかっこうな / 『不快な』,いやな(disagreeable) / (道徳的に)悪い,ひんしゅくを買う / (天侯・事態などが)『険悪な』,荒れ模様の / 《話》不きげんな;気むずかしい;けんか好きな: 
ulna	 (人の腕,動物の前肢の)尺骨 
undo	 〈結び目など〉‘を'『開く』,ゆるめる,〈ボタンなど〉‘を'はずす / 〈包みなど〉‘を'『開ける』;〈かんぬきなど〉‘を'はずす / 〈一度やったこと〉‘を'『元どおりにする』,取り消す / 《文》《しばしば受動態で》…‘を'破滅させる,だめにしてしまう
unit	 《集合的に》『構成単位』;(学習の)『単元』;(全体を構成する)部門,部隊 / (特定用途の)設備[一式],器具[一そろい] / (測定基準としての)『単位』;(…の)単位《+of+名》,(…する)単位《+for doing》 / 正の最小整数(1)
unto	 …に,の方へ,まで(to) 
upon	 『…の上に』 
urea	 尿素(にょうそ) 
urge	 〈人・馬など〉‘を'『駆り立てる』,〈進行・活動など〉‘を'急がせる,早める / 〈人〉‘を'『促す』,せきたてる:《urge+名〈人〉+to do 人をせかして…させる》 / (人に)…‘を'『力説する』,強く主張する(支持する,すすめる)《+名+upon(on)+名〈人〉》 / 《しばしば an ~》強い衝動,駆り立てる欲望:《urge for(to)+名…への衝動》
uric	 尿の,尿に関する(含まれている),尿から得られる 
used	 『使い古しの』,使用した 
user	 使用者,消費者 / 財産権[の使用]
vail	 (尊敬・服従を表して)〈頭・目など〉‘を'下げる / おじきする
vain	 『虚栄心の強い』,うぬぼれの強い,(容姿・能力などを)鼻にかける / 『むだな』,無益な,なんにもならない / むなしい,中身のない,空虚な 
vale	 谷,谷間 
vamp	 (靴の)つま先革 / 《話》即席伴奏 / 〈靴〉‘に'新しいつま先革をつける / …‘に'つぎをあてる,‘を'直す / 《話》〈曲・踊り〉‘に'即席で伴奏をつける《+名+up(out),+up(out)+名》 
vane	 =weather vane / (風車・扇風機・推進器などの)翼
vary	 (…から…に)『変わる』,変化する《+from+名+to+名》 / (…の点で)『互いに異なる』,いろいろである《+in(on)+名》 / …‘を'『変える』,変更する / …‘に'変化をつける,‘を'変化に富ませる
vase	 『花びん』;(装飾用の)つぼ 
vast	 『広大な』,広範囲な / (数・量・程度などにおいて)ものすごい,ばく大な
veal	 子牛の肉 
veil	 {C}『ベール』(婦人が顔を隠したり,装飾のために頭・肩などにまとう) / {C}(修道女の)ベール;修道女の生活 / {U}《しばしばa ~》(…を)おおい隠すもの(たれ幕,とばりなど),仮面,口実《+of+名》 / …‘を'ベールでおおう;…‘を'おおい隠す
vein	 〈C〉『静脈』 / 〈C〉(植物の)葉脈;(昆虫の)翅脈;(石の)石理;(木の)木目 / 〈C〉岩脈,鉱脈 / 〈U〉《しばしば a vein》(…の)傾向,性質《+of+名》 / 〈U〉《the vein》(…に対する)気分,気持ち《+for+名(doing)》 
vend	 (特に)〈小さな品物〉‘を'売る,行商する / (法律で)〈土地など〉‘を'売却する
vent	 (気体・液体の出入する)『抜け口』,漏れ口,通風(気)孔 / (鳥・魚などの)肛門 / 《単数形で》(感情の)はけ口 / …‘に'出口(はけ口)を与える / (…に向けて)〈感情など〉‘を'あらわにする,漏らす《+名+on+名》 
verb	 『動詞』 
very	 《副詞・形容詞・分詞形容詞を強めて》『非常に』,とても,たいへん,きわめて / 《否定語と共に用いて》『あまり』,さほど,たいして(…でない) / 《same, opposite, [one's]ownなどの前で》『真に,まったく』,ほんとうに / 《古》まったくの,本物の,真の / 《the(this,that,one's)~》『まさにその』,ちょうどその / 《the(one's)~》ただ…だけで(mere);(…)でさえ,までも(even)
vest	 《米》『チョッキ』(《英》waist-coat) / 《英》=undershirt / 《文》(権利・財産などを)<人>‘に'与える,授ける,付与する《+名<人>+with+名》 / (人に)<権利・財産など>‘を'与える,授ける《+名+in+名<人>》 / 《古》《詩》(法衣などを)〈人〉‘に'着せる / <権利・財産などが>(人に)属する,帰属する《+in+名》 / 《古》《詩》祭服を着る 
veto	 〈U〉拒否権;拒否権の行使 / (またveto message)〈U〉拒否通告状,拒否教書 / 〈C〉(一般に)(…の)拒否《+on+名》 / (拒否権を行使して)<議案など>‘を'拒否する / (一般に)…‘を'拒否する,光止する 
vial	 =phial 
vice	 〈U〉『悪徳』,不道徳 / 〈C〉(特定の)『悪徳行為』;《話》『悪習』,悪癖 / 〈C〉《話》欠点,欠陥 / 〈C〉〈U〉(馬・犬などの)悪癖
vide	 (特に読者に対して参照のため)…を見よ 
view	 〈C〉〈U〉(…を)『見ること』,ながめること,一見,一覧《+of+名》 / 〈U〉(…の)『視界』,視野《+of+名》 / 〈U〉《しばしばa ~》(…の)『ながめ』,光景,けしき《+of+名》 / 〈C〉(…の)風景画(写真)《+of+名》 / 〈C〉《しばしば単数形で》『見方』,考え方,見解 / 〈C〉意図
vile	 『下劣な』,堕落した,不道徳な / 身分の卑しい,みじめな / 《話》ひどく不快な;ひどく悪い 
vine	 (ツタ,キュウリなどの)『つる植物』 / =grapevine 1
vino	 安い普通のぶどう酒 
viol	 バイオル(16,17世紀に用いられた弦楽器で現在のviolin の前身) 
visa	 (旅券の)査証,ビザ,入国出国許可 / 〈旅券〉‘を'査証する
vise	 万力(まんりき)(《英》vice) 
void	 (法的に)『無効な』 / 《文》『空虚な』,からっぽの / 《補語にのみ用いて》《be void of+名》(…が)『ない』,欠けた / 〈U〉《the ~》(地球の回りの)『空間』,空所,虚空 / 〈C〉《単数形で》(地面・壁などの)すきま,割れ目 / 〈C〉《単数形で》『空虚感』,物足りなさ / (法的に)…‘を'無効にする / …‘を'からにする;…‘を'排泄(はいせつ)する
vole	 ハタネズミ(mouseやratの類だが尾の短いのが特色) 
volt	 ボルト(電圧の単位;{略}V;イタリアの物理学者 Alessandro Volta(1745‐1827)の名にちなんで) 
vote	 〈C〉『票』 / 〈C〉『投票』;(投票・挙手・起立などの)意志表示 / 〈C〉(…に関する)(投票・挙手・起立などによる)『決定』,票決《+on(about)+名》 / 《the vote》《時に複数形で》『投票権』,選挙権 / 《the vote,時に a vote》《集合的に》投票数,得票[数] / 投票する / 〈人〉‘に'『票を入れる』,投票する / 〈法案・予算など〉‘を'可決する / 《vote+名+名〈補〉》《話》《しばしば受動態で》世間が一致して…‘を'(…と)見なす / 《vote+that 節》《話》…すること‘を'提案する
wack	 おい,君 
wade	 《方向を表す副詞[句]を伴って》(川・雪などの中を)『歩く』 / 《話》(…を)苦労して進む,やっと切り抜ける《+through+名》 / 〈川など〉‘を'歩いて渡る 
waft	 …‘を'ふわりと運ぶ,漂わせる《+名+along》 / (空中を)ふわりと動く,漂う《+along》 / 一吹きの風 / 漂うにおい / 軽く手を一振りすること 
wage	 (通例肉体労働者の日・週ぎめの)『賃金』,給金 / 《単数・複数扱い》(罪などの)報い,応報 / (…に対して)〈戦争など〉‘を'行う《+名+against(on)+名》 
waif	 《文》放浪者,(特に)浮浪児 / 迷子になった動物
wail	 (苦しみ・悲しみなどで)泣き叫ぶ《+with(for)+名》 / 〈風などが〉悲しげな音を立てる / 《軽べつして》(…を)ぐちる,こぼす《+over(about)+名》 / …‘を'嘆く;〈…である〉‘と'嘆き悲しむ《+that 節》 / 嘆き悲しむこと;泣き叫ぶ声 
wain	 =wagon 
wait	 『待つ』 / 〈事が〉そのままにしておける,延期できる / (期待して)〈機会・合図など〉‘を'『待ち受ける』,待機する / 《話》(人や物を待って)…‘を'遅らせる / 〈C〉待つこと;待ち時間 / 〈U〉待ち伏せ
wake	 『目を覚ます』(awake)《+up》 / 《文》目を覚ましたままでいる,寝ずにいる《+up》 / (…に)気づく,目覚める《+up to+名》 / 〈人〉‘の'『目を覚まさせる』,‘を'起こす(awaken)《+名+up,+up+名》 / 《比喩的に》(…に)…‘を'目覚めさせる,窪づかせる,活発にする《+up+名(+名+up)+to+名》 / (死者のために)通夜をする / 《おもにアイルランド・イギリス北部》通夜 
wale	 むちで打たれた跡,みみずばれ / (織物などの)うね / 〈皮膚〉‘を'みみずばれにする 
walk	 《様態・方向を表す副詞[句]を伴って》『歩く』,『歩いて行く』 / 『散歩をする』,ぶらつく / (特定の態度で)ふるまう,生きる / (野球で)フォアボールで一塁に出る / (バスケットボールで)(パス・ドリブルしないで)3歩以歩く / 〈場所・道など〉‘を'『歩く』 / 〈動物〉‘を'歩かせる;〈人〉‘と'いっしょに歩く,‘を'案内する / 〈時間〉‘を'歩いて費やす《+away+名,+名+away》 / (野球で投手がフォアボールを与えて)〈打者〉‘を'一塁に歩かせる / 『歩くこと』,歩行 / 『散歩』,遠足 / 『歩行距離』,道のり / 『歩道』,散歩道,遊歩道 / (特徴をもった)湾き方,歩きぶり / (人・動物の)並み足,正常歩 / 職業,地位 / (野球で)フォアボールで一塁に出ること 
wand	 棒,(特に奇術師の)つえ / (職権を表す)職杖
wane	 〈月が〉『欠ける』;〈潮が〉引く《+away》 / 〈光・勢力などが〉衰える,弱まる / 〈季節などが〉終りに近づく / 月が欠けること / 衰え,衰弱 
wank	 =masturbate / =masturbation
want	 〈物事〉‘を'『ほしがる』,望む / 『…‘を'必要とする』 / want doing《おもに英》…されることが必要である / 〈人・物が〉…‘を'欠いている;〈ある数量〉‘だけ'不足している / 《しばしば受動態で》〈人〉‘に'『用がある』,会いたい,‘を'捜している / 『困窮する』;(…に)欠ける,(…が)無くて困る,(…を)必要とする《+for+名》 / 〈U〉《時に a want》(…の)『欠乏』,不足《+of+名》 / 〈U〉(…の)『必要』,入用《+of+名》 / 〈U〉困窮,貧困 / 《複数形で》必要なもの,ほしいもの
ward	 〈C〉『病棟』,病室 / 〈C〉(刑務所の)監房 / 〈U〉(未成年者などの)後見,保護;〈C〉被後見人 / 〈C〉(行政区画の)『区』 / 〈U〉警備,見張り / 〈危険・病気など〉‘を'避ける,‘から'身を守る《+off+名,+名+off》
ware	 《文》《複数形で》商品 / 〈U〉陶器
warm	 (気候が適度に)『暖かい』,温暖な / (飲み物などが適度に)『暖かい』,(衣服・場所などが)暖かく感じられる,(人が)暖まった,ほてる / 『心の暖かい』,思いやりのある;心からの,愛情のこもった / 熱した,激した,興奮した / (色が)暖かい,暖色(赤または黄を含む色)の / (獲物の遺臭・通った跡が)新しい,生々しい / 《話》(当て物ゲームなどで目的物に)近い,もう少しの / 『…‘を'暖める』,暖かくする《+up+名,+名+up》 / 〈人・心〉‘を'興奮させる,活気づける;〈人・心〉‘を'暖かい気持ちにする《+up+名,+名+up》 / 『暖まる』,暖かくなる《+up》 / 熱心になる,活気づく,興奮する《+up》 / (人・物に)優しくなる,好意を持つ《+to(toward)+名》 / 《a~》暖まること / 《the~》暖かい場所
warn	 〈人〉に『警告する』 / 〈人・物事などが〉〈人〉‘に'『予告する』 / 〈人・立て札などが〉(…に近寄らないように,…から立ち退くように)〈人〉‘に'通告する《+名〈人〉+away from(from,off,out of)+名》 
warp	 〈平らなもの・まっすぐなもの〉‘を'そらせる,ゆがめる,たゆませる / 〈心・判断・意味など〉‘を'曲げる,ゆがませる / 〈船〉‘を'引き綱で引く / ゆがむ,ひずむ / 〈C〉そり,ゆがみ;心のねじれ / 〈U〉(織物の)縦糸 / 〈C〉(船を引く)ロープ,引き綱 
wart	 いぼ / (木の)こぶ
wary	 注意深い,用心深い 
wash	 …‘を'洗う,洗濯する / 〈汚れ・しみなど〉‘を'『洗い落とす』《+名+away(off, out),+away(off, out)+名》;(…から)…‘を'洗い落とす《+名+off(out of)+名》 / 〈人・舟・家屋など〉‘を'『洗い流す』,押し流す《+名+away(along,down,up),+away(along,down,up)+名》,(…から)…‘を'洗い流す《+名+off(away from)+名》 / 〈波などが〉〈岸など〉‘を'『洗う』,‘に'打ち寄せる;〈雨などが〉…‘を'ぬらす,うるおす / (塗料などで)…‘を'薄く塗る;…‘を'メッキする《+名+with+名》 / 〈雨水などが〉…‘を'浸食する《+名+away(out),+away(out)+名》;〈雨だれなどが〉〈穴など》‘を'うがつ / (特に手・顔・体を)『洗う』 / 『洗濯する』 / 〈布地が〉洗濯がきく;〈洗剤などが〉よごれを落とす;〈しみなどが〉洗って落ちる《+off(out);(…から)〈しみなどが〉洗って落ちる《+off(out of)+名》 / 〈波などが〉(…に)『打ち寄せる』,(…を)洗う《+against(over)+名》 / 〈U〉《しばしば a~》『洗うこと』,洗濯 / 〈U〉《時に a~》《集合的に》(一度の洗濯の)『洗い物』,洗濯物 / 〈U〉〈C〉《しばしば複合語を作って》洗い薬,洗浄剤;(…のための)洗い薬《+for+名》 / 〈U〉《the~》(波の)打ち寄せ,(波の)打ち寄る音《+of+名》 / 〈C〉(絵の具・塗料などの)薄い一塗り;薄いメッキ / 〈U〉(船のあとに引く)白波,航跡;(飛行機などのあとに残る)気流の渦 / 洗濯のきく 
wasp	 スズメバチ,ジガバチ / 怒りっぽい人
wast	 主語が
wave	 (前後左右・上下に)『揺れる』,ひらめく,ひらひらする / (波形に)『起伏する』,うねる / (手・旗などを振って)『合図する』,手を振る;(…のために,…に向かって)手を振る《+in(to, at)+名》 / (に向かって)‘…を'振る,揺り動かす,ひらめかす《+名+at+名》 / 《方向を表す副詞[句]を伴って》(手・旗などを振って)〈人〉‘に'『合図する』 / ‘…を'起伏させる,うねらせる:〈頭髪〉‘を'ウエーブさせる / 『波』,波浪 / (…の)『波のような動き』,うねり《+of+名》 / (感情・景気などの一時的な)高まり,強まり;(寒暑の)急激な波《+of+名》 / (手・旗などを)振ること,振ってする合図;(…を)振ること《+of+名》 / (髪の)縮れ,ウエーブ / (光・音・電気などの)波
wavy	 波立っている / 波形の,起伏する
waxy	 (手ざわり・外観が)ろうのような,すべすべした,青白い / ろう製の,ろう核きの
weak	 (物が)『弱い』 / (通常よりも)『衰えている』,力が弱い,勢いがない / (性格の点で)『弱い』,意志薄弱な / 『劣っている』 / (相場などが)値下がりぎみの / 水っぽい,薄い / (音節・母音・語が)強勢のない,弱強勢の;(動詞が)弱変化の 
weal	 福祉,幸福,繁栄 
wean	 <赤ん坊・動物の子>‘を'離乳させる / (楽しみ・習慣などから)<人>‘を'引き離す,思い切らせる《+名<人>+away from+名(doing)》
wear	 <服・靴・帽子・装飾品・ひげなど>‘を'『身につけている』 / 〈ある表情・態度など〉‘を'『表している』,示している / (使用して)…‘を'『すり減らす』,使いふるす;(摩擦などで)…‘を'を損なう / 〈穴・みぞなど〉‘を'すり減らして作る(あける) / (使用・摩擦などで)『すり減る』,すり切れる / 《様態・時間を表す副詞[句]を伴って》〈品物などが〉長もちする / 『着用』,使用 / 《集合的に》《単数扱い》『衣類』,衣料品 / すり切れ,消耗,摩滅 / (衣類などの)耐久力,もち
weft	 (織物の)横糸 
weir	 せき(川に設けた小さなダム) / やな(魚を取るために川の中に作る囲い)
weld	 〈金属など〉‘を'溶接する《+『名』+together,+together+『名』》;…‘を'(…と)結合させる《+『名』+to+『名』》 / 〈金属・プラスチックなどが〉溶接される,用接できる / 溶接した部分 
welt	 (靴の底と上皮との)継ぎ目皮 / 縁飾り,へりかがり / みみずばれ 
wend	 《文語》[～ one's way で]行く，旅行する　古期英語「まわる」の意; go の過去形はこの過去形 《古》 went から 
went	 goの過去 
wept	 weepの過去・過去分詞 
wert	 were(主語が thou のときの be 動詞の直説法および仮定法の過去形) 
west	 《the west》『西』;(…の)西方,(…の)西部《+of+名》 / 《the West》『西洋』西欧,欧米 / 《the West》《米》西部地方 / 《the West》(共産圏に対して)西側[諸国],西側陣営 / 『西の』,西部の,西向きの;西からの / 『西へ』,西に;西方に
wham	 ドカーン(グァーン)[という音] / 激突;強打 / ドカーンという音を立てる / …‘を'グァーンと強打する
what	 《疑問代名詞》 / 《情報・種別・数量などを求めて》『何』,どんなもの(こと) / 《職業・地位・国籍などを尋ねて》どんな人,何をする人 / 《相手の言葉が聞きとれないときなどにその反復を求めて》 / 《関係代名詞》 / 《名詞節を導いて》『…するもの(こと)』 / 《副詞的に働く挿入節を導いて》『…なことには』 / 《A is to B what C is to Dの形で比例関係を表す》…が…に対するごとく / 《疑問形容詞》『何の』,何という,どの,どんな / 《感嘆文で》『何という』 / 《関係形容詞》…『するものは何でも』;…だけの / いかに,どれほど / 《驚き・怒り・当惑など》『なんだって』,なに,えっ,おや 
when	 《疑問副詞》(句・節を導くこともある)『いつ』 / 《関係副詞》 / 《制限的用法》(…する,…した)『ところの』 / 《非制限用法》『するとその時に』,そしてそれから / 《先行詞を含んで》…『する』(…である,…した) / 『…する』(…である)『ときに』;…すると / 『…するときはいつでも』 / 『…[な]のに』,にもかかわらず / 『…であるから』 / 『もし…ならば』 / 《疑問代名詞》『いつ』 / 《非制限用法の関係代名詞》《前置詞の目的語》《おもに文》そしてそのとき / 《the~》時,日付,場合 
whet	 〈ナイフなど〉‘を'研ぐ,みがく(sharpen) / 〈食欲・関心など〉‘を'刺激する,そそる
whey	 乳清(チーズを作るとき分離される水溶液) 
whim	 気まぐれ,でき心,むら気 
whin	 ハリエニシダ 
whip	 『むち』;《比喩的に》訓練のむち / (キツネ狩りの)猟犬係 / (政党所属議員の出席を督励する)院内幹事 / ホイップ(泡立てた卵の白身かクリームで作るデザート) / 〈人・動物〉‘を'『むちで打つ』,‘に'むちを当てる / (人・動物に)…‘を'むち打って教え込む《+名+into+名》;(…から)〈悪癖など〉‘を'むちでやめさせる《+名+out of+名》 / 《方向・状態を表す副詞[句]を伴って》〈物〉‘を'『ぱっと動かす』 / 〈布の縁〉‘を'かがる;〈棒・ロープの端〉‘に'糸(ひも)を巻きつける,‘を'端止めする / (むちで打つように)…‘を'ピシッとたたく,たたきつける / 〈卵・クリームなど〉‘を'かき回して泡立てる / 《話》(競技などで)…‘を'打ち負かす / 〈川・湖など〉‘で'投げ釣りをする / 〈こま〉‘を'ひもを打ちつけて回す / 《方向・状態を表す副詞[句]を伴って》〈人が〉急に動く(行く,来る,通る) / 〈旗などが〉はためく / 《方向を表す副詞[句]を伴って》〈風・雨が〉激しく打つ,しの突くようにたたきつける
whit	 微量(bit) 
whoa	 (特に馬に対して)どおどお,止まれ(stop) 
whom	 《疑問代名詞》『だれを(に)』,どんな人を(に) / 《関係代名詞》 / 《制限用法》(…する,…した)『ところの』 / 《非制限用法》『そしてその人を(に)』
whop	 《話》…‘を'強く打つ / 《俗》(競技などで)…‘を'完全に負かす / 《米》ドシンと倒れる / 強打,一撃
wick	 (ろうそく・石油ランプ・ライターなどの)芯,灯心 
wide	 『幅の広い』 / 《修飾語を伴って》『幅が…の』,…の幅の / 『広範囲な』,多方面にわたる;広大な / 『大きく開いた』 / (球が)大きくそれた / 『広く』,広範囲に / 『広く開いて』,十分に開けて 
wife	 『妻』,女房,奥さん,夫人 / 《古》(特に結婚した)女
wild	 (植物・果実・はちみつなどが)『野生の』 / (鳥獣などが)『野生の』,飼い慣らされていない / (人・気性などが)『乱暴な』,無法な,手に負えない / 《おもに補語に用いて》『気違いじみた』,熱狂的な,ひどく興奮した / 《補語にのみ用いて》『熱望して』;夢中になって / (天候・海・時勢などが)『荒れた』,激しい / (人・種族などが)『未開の』 / (土地などが)『自然のままの』,荒涼とした / (計画などが)『とっぴな』,でたらめな / 的はずれの,見当違いの / 乱れた,だらしない / 《話》よい,愉快な / 『乱暴に』,やたらに;でたらめに / 荒野,荒れ地,大自然のままの状態
wile	 たくらみ,策略,手管(trick) / …‘を'たぶらかす,だます / 《おもの米》〈時間〉‘を'まぎらせる《+away+『名』,+『名』+away》 
wilt	 =will 
wily	 ずるい,こうかつな 
wind	 〈C〉〈U〉《しばしば the wind》『風』 / 〈C〉〈U〉『強風』,暴風 / 〈U〉《the wind》(せんす・扇風機などによる人工的な)『風』,あおり / 〈U〉『息』,呼吸[する力],肺活量 / 〈C〉(風の吹いてくる)方向;《複数形で》方位,方角 / 〈U〉(風で運ばれてくる獲物・狩人などの)におい,臭跡;(…の)予感,気配《+of+名》 / 〈U〉《話》実のない話,むだ話,空言,無意味 / 〈U〉(腸内の)ガス / 《the winds》《集合的に》(オーケストラの)管楽器部,管楽器演奏者 / 〈獲物など〉‘を'においをかぎ出す;〈秘密など〉‘を'かぎつける / (運動などで)…‘を'息切れさせる / 〈特に馬〉‘に'一息入れさせる,一休みさせる
wine	 〈U〉〈C〉『ワイン』,ぶどう酒 / 〈U〉〈C〉(種々の)果実酒 / ワインカラー,赤紫色 / 〈人〉‘を'ワインでもてなす / ワインカラーの,赤紫色の 
wing	 (鳥の)『翼』,(昆虫の)羽 / (飛行機・風車などの)『翼』,羽 / (建物の)翼(よく),そで / (政党などの)『分派』,…翼 / 《複数形で》(舞台の)そで,たもと(観客から見えない部分) / (サッカーなどの)ウィング,ウィングの選手 / (部隊・艦隊の左右の)翼,側面部隊;(空軍の)飛行大隊 / 《複数形で》パイロット記章 / 《英》=fender 1 / 《wing one's way の形で》飛んで行く / …‘を'飛ばす;…‘に'スピードをつける / (…で)…‘に'翼をつける《+名+with+名》 / 〈鳥〉‘の'翼を傷つける,〈人〉の腕を傷つける / 〈芝居の役など〉‘を'せりふを暗記しないで演じる / 《方向を表す副詞[句]を伴って》飛ぶ 
wink	 (合図として)(…に)『目くばせする』,ウインクする《+at+名》 / 〈人・両眼が〉『まばたきする』,まばたく / 《英》きらきらする,〈星・光が〉またたく(《米》blink) / 《古》(眠くて)目をつむる / 〈目〉‘を'まばたきさせる;(…に)〈目〉‘を'ウインクして合図する《+名+at+名》 / 〈涙など〉‘を'まばたきして払いのける《+back(away)+名,+名+back(away)》 / 〈同意など〉‘を'ウインクで合図する / 《英》〈光・灯など〉‘を'点滅させる(《米》blink) / 〈C〉ウインク,目くばせ / 〈C〉まばたき,またたき;(光の)きらめき / 〈U〉《しばしば a wink》《通例否定文で》またたく間,一瞬間(の…)《+of+名》 
wino	 [安]ぶどう酒びたりの人,のんべえ 
winy	 (味・香りなどが)ワインの[ような] 
wipe	 〈物など〉‘を'『ふく』,ふぐう / 〈よごれなど〉‘を'『ふき取る』,ぬぐい去る《+『away』(『off』)+『名,』+『名』+『away』(『off』)》;(…から)…‘を'ふき取る《+『名』+『off』(『from, out of』)+『名』》 / (…に)〈布など〉‘を'こすりつけてふく(ぬぐう)《+名+over(across)+鳴》 / ふくこと,ぬぐうこと
wire	 〈U〉〈C〉『針金』,金属線 / 〈C〉『電線』,ケーブル;金網 / 《おもに米》〈U〉〈C〉『電報』(telegram) / …‘を'『針金で結ぶ』《+名+together》 / (…のために)〈家など〉‘に'電線を取り付ける《+名+for+名》 / 〈人〉‘に'『電報を打つ』 / (…に…を求めて)電報を打つ《+to+名+for+名》 
wiry	 針金製の / 針金のような,堅い / (人が)やせているががん強な 
wise	 (人・行為などが)『賢い』,賢明な,思慮分別のある / 『博識な』,学識豊かな;事情に詳しい,物事が分かっている / 《俗》生意気な / …‘を'気づかせる,…‘に'教える《+up+『名』,+『名』+up》 / (…に)気づく,(…を)知る《+up to+『名』》 
wish	 《現在の反対への願望を表して》《wish+that『節』》…『であればよいのにと思う』 / 《過去の事実と反対の仮定・想像を表して》《wish+that『節』》…『であればよかったのにと思う』 / …‘を'『望む』,したい / 《『wish』+『名』〈人〉+『名』=+『名』+『to』+『名』〈人〉》〈人〉に〈あいさつ,幸運を祈る言葉など〉‘を'『述べる』,言う,祈って言う / 《実現の可能性がある願望》…であればよいと思う / (…に)…‘を'押しつける,無理して頼む《+『名』+on(upon)+『名』》 / (…を)『望む』,ほしがる《+for+『名』》 / (…に)願いをかける《+on(upon)+『名』》 / 〈C〉〈U〉『願い』,願望,希望 / 〈C〉《複数形で》(人の幸福などを願う)『祈願』,好意 / 〈C〉『望みの物』,願いごと 
wisp	 (毛髪・わら・小枝などの)房,一握り,小束《+of+名》 / (煙・雲などの)一片,細長いもの《+of+名》 / ほっそりした(人・物)《+of+名》 
wist	 wit の過去・過去分詞 
with	 《随伴・協調》…『と』,と共に,といっしょに / 《所有・所持》…『を持っている』,がある,の付いた / 《道具・手段》…『で』,を使って / 《財料・供給物》…『で』,を与えて / …を支持して,に賛成して / …『に反対(敵対)して』,を相手として / …『と同時に』,と同様に / …『に比べて』,に比例して / 《様態》《名詞を伴い副詞句として》『…で』,を示して,をもって / 《付帯状競》…『して』,しながら / 《譲歩》…がありながら,にもかかわらず / 『…が原因で』,のために,…で / …に任せて,のもとにあずけて,のところに / …に関して,について / …から離れて / 《連結・混合》…と / 《副詞と共に命令文で》 
wive	 （古語）…‘を'めとる / 妻帯する
woad	 (大青(たいせい)から採った)青色染料 
woke	 wake の過去 
wold	 高原,丘陵 
wolf	 〈C〉『オオカミ』 / 〈U〉オオカミの毛皮 / 〈C〉(オオカミのようにひどく)どん欲な人,残忍な人 / 〈C〉女たらし,色魔 / (オオカミのように)…‘を'がつがつ食う,むさぼり食う《+down+名,+名+down》 
womb	 子宮 / 《比喩的に》物の発生(成長)するところ
wont	 《be wont to do》…し慣れて,するのを常として / (特定の人の)習慣
word	 〈C〉『語』,単語 / 《しばしば複数形で》(表現された)『言葉』;(自分の考えに基く)言葉 / 〈C〉《しばしば複数形で》『短い会話』,ひと言 / 《単数形で;one's word》『約束』,保証 / 〈U〉《冠詞をつけずに》『知らせ』,伝言 / 《the word》合い言葉 / 〈C〉《the word, one's》命令,指図 / 《複数形で》『口論』,論争 / 《the Word》聖書,(聖書に書かれた)神の言葉 / …‘を'言葉に表す
wore	 wearの過去 
work	 〈U〉(一般的な)『仕事,』労働;努力,勉強 / 〈U〉(実際にやっている具体的な)『仕事』,作業,勉強 / 〈U〉《定冠詞なしで》『仕事の口,』職[業],(工場・会社などの)勤め先 / 〈U〉制作,細工;《比喩(ひゆ)的に》しわざ / 〈C〉《しばしば複数形で》(文学・芸術の)『作品,』著作,(ある人の)作品 / 〈U〉《集合的に》(材料・道具などを含めて)作っているもの(今しているもの)全部 / 《複数形で》(機械の)動く部分,仕掛け / 《複数形で》《単数・複数扱い》《しばしば複合語を作って》『工場』 / 《複数形で》(宗教・道徳的な)行為,行い / 〈U〉(物理学で)仕事量 / 『働く』,仕事をする;(…に)取り組む,(…を)勉強する《+『at』(『on』)+『名』》 / (…に)『勤める』,勤務する《+『at』(『on, for』)+『名』》 / 《しばしば副詞[句]を伴って》〈機械・道具などが〉『ぐあいよく動く,』作動する,〈計画などが〉うまくいく,〈薬などが〉効く / 《副詞[句]を伴って》(ある方向に)少しずつ進む / 〈顔などが〉ぴくぴく動く,〈波などが〉揺れる / 《通例副詞を伴って》細工される,こねられる / 発酵する / 〈機械・道具など〉‘を'『動かす』,運転する / 〈人・牛馬など〉‘を'『働かせる』 / 〈工場・鉱山・農場など〉‘を'操業(経営)する,〈土地〉‘を'耕作する / 〈ある地域〉‘を'活動場所にする,受け持つ / 〈結果・効果など〉‘を'もたらす,生じさせる / (手で)…‘を'細工する,加工する;…‘に'手を加えて(…を)作る《+名+into+名》 / 《副詞[句]を伴って》(苦労して)…‘を'進む,(努力して)…‘を'得る / 〈人・物〉‘を'動かして(…に)する《+名+to(into)+名》 / …‘を'刺しゅうする,縫い付ける
worm	 〈C〉(細長く柔らかい)『虫』(毛虫・うじ虫・ミミズ・回虫など) / 〈C〉(形・動きが)ミミズなどに似たもの,(いも虫状の)ねじのらせん / 〈C〉虫けらのような人間;哀れな(下劣な)人 / 《複数形で;単数扱い》寄生虫病 / (虫のように)体をくねらせて進む / …から寄生虫を駆除する
worn	 wearの過去分詞 / 『すり切れた』,ほころびた / 『疲れはてた』,やつれた 
wort	 麦芽汁(ビールの原料) 
wove	 weave の過去 
wrap	 (人・物に)…‘を'『巻きつける』,掛ける《+『名』+around(about)+『名』〈人・物〉》 / (…で)〈人・物〉‘を'『くるむ』,包む〈+『名』〈人・物〉+『up』(+『up』+『名』+『in』+『名』》 / 《話》…‘を'終了する《+up+『名』,+『名』+up》 / 衣服の上に着る外衣(スカーフ,ショール,コートなど)
wren	 ミソサザイ(北半球に広くすむ小鳥;暗褐色に黒じまがある) 
writ	 〈C〉令状: / 《the Holy Writ》聖書
yang	 (中国思想の)陽 
yank	 …‘を'ぐいと引っ張る / (…を)ぐいと引っ張る《+at+名》 / ぐいと引っ張ること 
yard	 ヤード(長さの単位で3フィート,約91.4センチ;《略》櫻.(複 yds.));(日本で布を測るときの)ヤール / (特に建築業で)1立方ヤード / 帆げた 
yarn	 〈U〉(織物・編み物用の)『糸』 / 〈C〉《話》物語,話;(特に)長い冒険談,ほら話 / 長話(ほら話,冒険談)をする 
yawl	 (2本マストの)小型帆船 / (オールでこぐ)船載ボート
yawn	 『あくびをする』 / 〈口・割れ目などが〉大きく開く / …‘と'あくびをしながら言う / 『あくび』
yaws	 いちご腫 
yeah	 =yes 
year	 〈C〉(グレゴリオ暦で1月1日に始まり12月31日に終わる)『年』,暦年(calendar year) / 〈C〉(任意の時からの)『1年間』,12か月 / 〈C〉年度;(特定の)1年 / 〈C〉…『歳』;《複数形で》年齢 / 《複数形で》老齢(old age) / 《複数形で》長い年月,長月,多年 / 《複数形で》時代 / 〈C〉(天文学上の)暦年
yelp	 〈犬などが〉キャンキャンほえる;〈人が〉悲鳴(叫び声)をあげる / (犬などの)キャンキャン鳴く声;(人の)短い叫び声(悲鳴)
yeti	 =Abominable Snowman 
yoga	 ヨガ[の行](黙想的修行) 
yogi	 ヨガの行者 
yoke	 〈C〉『くびき』(2頭の牛を首のところでつなぐ器具) / 〈U〉(くびきでつないだ)2頭の牛 / 〈V〉くびき状のもの;(おけなどをかつぐ)天びん棒 / 〈U〉《the yoke》(…の)束縛,支配《+of+名》 / 〈C〉《単数型で》(…の)きずな,結びつき《+of+名》 / 〈C〉(衣服の)ヨーク,えり肩 / 〈牛・馬など〉‘に'くびきをかける,‘を'くびきでつなぐ / …を結びつける,いっしょなする / 結びつく,連れになる 
yolk	 (卵の)黄身,卵黄 
yore	 昔,往時 
your	 『あなた[がた]の』,君[たち]の / 《話》《しばしば非難や軽べつの意を込めて》君[たち]のいう,例の,いわゆる / 《一般に人を指して》人の / 《敬称の一部として》
yowl	 (動物の)長く悲しそうな叫び席 / 〈動物が〉長く悲しそうに叫ぶ(howl)[擬声語]
yuan	 ユアン,元(中華人民共和国の貨幣単位) 
yurt	 ユルト(中央アジアの遊牧民が使う円形の移動式テント) 
zany	 ばかげた冗談を言う人,ひょうきん者 / うすのろ,あほう / ひょうきんな,おどけた;ばかみたいな 
zeal	 (…に対する)『熱心』,熱中,熱意(ardor)《+for+名》 
zebu	 コブウシ(アジア・アフリカで飼育されている家畜) 
zero	 〈U〉(アラビア数字の)『0,零』,ゼロ / 〈U〉(温度計の)『零度』;(尺度の)零位;零点 / 〈U〉無,空(くう)(nothing) / 〈U〉最下点,どん低 / 零の,ゼロの / 〈計器など〉‘を'ゼロの目盛りに合わせる
zest	 (…に対する)『強い興味』,熱意《+『for』+『名』(do『ing』)》 / さわやかな(ぴりっとする)味,趣,(レモンの皮など)風味を添えるもの
zeta	 ゼータ(ギリシア語アルファベットの等6字Ζ,ζ;英語のZ,zに相当) 
zinc	 亜鉛(金属元素;化学記号は Zn) 
zing	 ヒューン(ビューン)という音 / 〈U〉《米話》活力,元気 / ビューンという音を立てる,ビューンと動く(飛ぶ) 
zone	 (何らかの目的・特徴などによって他の地域と区別された)『地帯』,地域,地区(belt, area) / (気候によって地球を大別した)帯(たい) / 《米》(交通・郵便などの)同一料金区域;(郵便番号で分けた)郵便区 / (環状の)ベルト,輪,帯 / …‘を'地帯(地区)に分ける / (…の目的に)〈地域〉‘を'区画規制する《+名+as(for)+名》 / …‘を'帯で巻く,‘に'帯印をつける 
