abhor	 …'を'ひどくきらう,嫌悪する 
abide	 (ある状態に)とどまる;残る / 住む / 《まれ》…'を'じっと待つ / 《否定文・疑問文で》…'を'がまんする,‘に'耐える
abode	 〈C〉住所,住居 / 〈U〉滞在,居住 / abideの過去・過去分詞 
abort	 流産する / 〈動植物や器官などが〉十分に発育しない / 〈計画が〉失敗する,中止となる / 〈胎児〉'を'流産させる / 〈計画など〉'を'中止する 
about	 …『について』,に関して / 《おもに英》(また,おもに《米》『around』)…『の回りに(を)』,の周囲を(で) / 《おもに英》(また,おもに《米》『around』)…『のあちこちに(で,を)』,に点々と / 《おもに英》(また,おもに《米》『around』)…のあたりに(を),の近くに(near) / …『の身の回りに』,を手もとに / …の身辺に,のどこかに / …に従事して,にかかわって / (また《話》『around』)《時を表す名詞を伴って》だいたい…ころ(に) / (また《米》『around』)『周囲に』 / 《おもに英》(また,おもに《米》『around』)『あちこちに』,点々と / 《おもに英》(また,おもに《米》『around』)あたりに / 《しばしば数詞と共に用いて》『およそ』,約 / (また,おもに《米》『around』)ぐるっと回って,反対の位置(方向)に / 順番に,交互に / 《be動詞の後で》(病気・うわさが)広まって;(人の病気がよくなり)元気に動き回って;(ショーなどが)行われて 
above	 《方向》《fly,go,riseなどの移動を表す動詞と結びついて》…『の上方へ』,より高いところへ / 《場所・位置》…『の上に』,の上方に,さらに高いところに(の) / …『の上流に(で)』,の上手(かみて)に,の北方に,のもっと先(遠く)に / 《数・量・程度》…『以上に』,にまさって / 《be動詞と結びついて》…『の力の及ばない』,を越えて(beyond) / 『上方に(を)』;頭上に高く;上流に / 天に,空に / (特に地位において)高位に / (本・ページの)『前に』,前文に / 前述の,上述の / 前述(上述)のこと 
abuse	 〈U〉〈C〉(自分の,あるいは人の権利などの)『乱用』,悪用《+『of』+『名』》 / 〈C〉《しばしば複数形で》悪習,悪弊 / 〈U〉『悪口』,悪態,ののしり / 〈地位・権力など〉'を'『乱用する』,悪用する / …'を'『虐待する』(maltreat),酷使する / …'を'『ののしる』,‘の'悪口をいう
acerb	 (味が)すっぱい(sour),苦い,渋い / (ことば・態度が)厳しい,しんらつな
acorn	 どんぐり(カシ・ナラなどの実) 
acrid	 (舌・鼻に)刺激のある,ひりひりする / (言葉・態度・気質が)しんらつな,とげとげしい
actin	 純蛋白質(筋肉生成に役立つ) 
actor	 (男の)『俳優』,『男優』 / 行為者
acute	 (先の)『鋭い』,とがった / (痛み・感情などが)『激しい』,強い / (知力・感覚などが)『鋭い』,鋭敏な / (事態が)重大な / (病気が)急性の / (音が)高い,鋭い / 鋭角の 
adept	 熟達した,精通した;(…に)巧みな《+in(at)+名(doing)》 / 〈C〉(…に)熟達した人,(…の)名人《+『at』(『in』)+『名』(do『ing』)》
adieu	 さようなら,ごきげんよう(good-by) / 別れ,告別(farewell)
adios	 さようなら 
adlib	 〈楽譜にないもの〉'を'即興的に歌う(演奏する),〈台本にないせりふ〉'を'即興的にしゃべる / 即興的に歌う(演奏する,しゃべる) / 《名詞の前にのみ用いて》即興の,アドリブの / アドリブで,即興で / アドリブ,即興的な演奏(演技,せりふ) 
admit	 (場所・会・学校などへ)…'を'『入れる』,‘に'入ることを許す《+『名』+『to』(『into』)+『名』》 / 〈事実・要求・誤りなど〉'を'『認める』,受け入れる / 〈場所・建物などが〉〈人・物〉'を'収容できる 
admix	 (…と)…'を'混合する《+『名』+『with』+『名』》 / 混合する,まざる(mix)
adobe	 〈U〉《集合的に》(泥を固め天日で干して作る)アドービれんが　日干し煉瓦 / 〈C〉アドービれんが造りの家屋(米南西部・メキシコ・南米に多い) / アドービれんが造りの 
adopt	 〈考え・習慣など〉'を'『取り入れる』,採用する / (法律によって)(…として)…'を'養子にする,家族(部族)の一員にする《+『名』+『as』+『名』》 / (投票など正式な手順で)…'を'採択する,承諾する 
adore	 〈人〉'を'『深く愛する』,敬愛する / 〈神〉'を'あがめる,崇拝する(worship) / 《話》…‘が'大好きである 
adorn	 (装飾品などで)…'を'『飾る』《+『名』+『with』+『名』》 
adult	 『おとなの』,成人した,成熟した / 成人向きの / 『おとな』,成人 
aegis	 保護,援助 
afire	 (…で)燃えた(on fire)《+『with』+『名』》 / 燃えて
afore	 =before 
afoul	 衝突して;もつれて 
after	 《時・順序》…『の後に』,…後に;…の次に / …『を求めて』,の後を追って / …『の名をとって』,にならって;…ふうに(の) / …のことを心配して,に関して / …『だから』,…の結果 / 《前後に同じ名詞を用いて連続・反復など》 / 《時》…『した後で(に)』,してから / 《順序・時》『後に』,後ろから,後で / 後の,次の 
agent	 『代理人』;周旋人 / 働き(作用)を起こすもの;作用物,薬剤 / (政府機関,特にFBI,CIAなどの)部員,機関員 
agile	 (動作が)機敏な,すばやい / (頭脳の働きが)明敏な,回転の速い
aglow	 (空などが)(…で)赤々と輝いて《+『with』+『名』》 / (興奮などで)赤らんで;(誇りなどに)燃えて《+『with』+『名』》
agony	 (長く激しい精神的・肉体的な)『苦悶』(くもん),苦痛 / (特別な感情の)激発;突発
aisle	 (教会・劇場・列車・旅客機などの)座席間の通路 / 側廊(教会堂で本堂(nave)の両側にある通路)
aitch	 H,hの字(音) 
album	 (写真・切手・切り抜きなどを貼る)『アルバム』 / (いくつかの曲・劇などを収録した)組レコード,アルバム / 画帳 
alder	 ハンノキ(建築用落葉高木) 
alert	 『油断のない』,用心深い / (頭の回転・動作などが)機敏な / (動作が)敏しょうな / 〈U〉《しばしばthe ~》警戒,用心 / 〈C〉警報;警報発令期間 / (…に対して)…‘に'警報(警告)を出す,警戒態勢をとらせる《+『名』+『to』+『名』》
alien	 『外国の』,異国の;外国人の,在留外国人の / 《補語にのみ用いて》(…と)性質の異なる《+『from』(『to』)+『名』》 / 《補語にのみ用いて》(…と)相いれない,(…に)反する《+『to』+『名』》 / 異常な / (ある国に在住する)外国人,在留外国人;(citizenと区別して帰化してない)外国人 
alike	 『同じように』,等しく(similarly) / (複数の人・物が)似ている(similar)
aline	 =align 
alive	 『生きている』(living) / 《しばしば最上級の形容詞と共に》現存している / 活動している,有効である(active) / 生き生きした,活発な
aloft	 空中高く,上に / マストの頂上に
alone	 『ひとりで』,一つで,単独で;ただ…だけで / 《名詞・代名詞のすぐ後に用いて》ただ…だけ(only)
along	 『…をたどって』,…に沿って / …の間に(during),…の途上で / 『沿って』,並んで / 《動作や状態の継続を強めて》前へ,進んで / (人を)連れて;(物を)持って 
aloud	 声を出して / 大声で(loudly)
alter	 (形・性質などの点で)…'を'変える,改める / 変わる,改まる
amber	 こはく(琥珀)(宝石に用いる黄褐色の鉱石) / こはく色 / こはく製の / こはく色の
ambit	 周囲 / 勢力範囲
amble	 アンブル,側対歩(馬が片側の両脚を同時に上げて進むゆるやかな歩調) / のんびりした歩き方,ゆっくりした足どり;ぶらつき,散歩 / 〈馬が〉アンブルで歩む / 〈人が〉ゆっくり(ぶらぶら)歩く《+『about』(『around』)》
amend	 …'を'『改める』,改良する / (正式に)〈議案など〉'を'修正する,改正する / 品行を改める,行いを良くする 
amide	 アミド[基化物] 
amigo	 友人 
amity	 (人・国などの間の)親善,友好,親和 
among	 …『の間に』,に囲まれて / 《おもに最上級と共に》…『の中の一つ』(『一人』)『で』,のうちに数えられて / 《分配を表す動詞と共に》…『の間で』,めいめいに / …がいっしょになって,が協力して
amour	 (特に人目をはばかる)恋愛,情事 
ample	 広い,広々とした / 《数えられない名詞・複数名詞の前に用いて》『十分な』(enough),あり余るほどたくさんの(abundant) / ふくよかな,豊満な(full) 
amply	 広々と,広く / 豊富に,十分に(fully)
amuck	アモク 《急に興奮して殺人を犯す精神障害; 元来マレー人特有のものとされた》/殺気立って[た]; 怒り狂って[た].
amuse	 (…で)〈人,自分自身〉'を'『楽しませる』,おかしがらせる《+『名』+『with』+『名』/+『名』+『by』 do『ing』》 
angel	 『天使』 / (美しさ・親切さなどで)天使のような人 / 守護神,守り神 
anger	 『怒り』,立腹 / …'を'おこらせる(make angry) / おこる(become angry) 
angle	 『かど』,すみ(corner) / 『角』,角度 / 《話》(ものを見る)角度,観点(point of view) / …'を'ある角度に動かす(向ける,曲げる) / …'を'ある角度から見る 
angry	 『おこった』,腹を立てた / (海・波・風などが)おこったような,激しい / (傷が)炎症を起こした 
angst	 (ばく然とした)不安 
anile	 老婆の[ような];もうろくした 
anise	 アニス(地中海沿岸産のセリ科の草;実は香味料) 
ankle	 『足首』,くるぶし 
anode	 (電気の)陽極(positive pole) 
antic	 おどけたしぐさ,異様な行動 / 《文》おどけた,奇妙な
anvil	 (かじ屋が使う)金敷き,金床 / (耳の)きぬた骨
aphid	 アブラムシ(草木の害虫)(plant louse) 
aphis	 =aphid 
apish	 (特に行動が)サルのような,馬鹿なことをする 
apron	 『エプロン』,前掛け / (また『apron stage』)張り出し舞台 / エプロン(飛行機の乗降・荷積み・給油などをする所) 
aptly	 適切に 
argon	 アルゴン(気体元素;化学記号は『Ar』) 
argot	 (ある仲間の間で使われる,特に盗人の)隠語 
argue	 (人と…について)『議論する』,論争する,言い争う《+『with』+『名』〈人〉+『about』(『on, over』)+『名』》 / (…に賛成・反対して)論じる,主張する《+『for』(『in favor of, against』)+『名』》 / …'を'『議論する』,論じる / (…するように)〈人〉'を'『説得する』,説き伏せる《+『名』〈人〉+『into』+『名』(do『ing』)》,(…しないように)〈人〉'を'説得する《+『名』〈人〉+『out of』+『名』》 / 〈物事が〉…'を'示す,表す(show) 
arise	 〈問題・事件などが〉『起こる』,現れる / (…から)生じる(result)《+『from』+『名』》 / 《古・詩》起き上がる,立ち上がる / 《英ではまれ》〈霧・煙などが〉立ちのぼる,湧きあがる
arith	 arithmetic / arithmetical
armed	 武装した / (ある目的のために)用意した
arose	 ariseの過去形 
arson	 放火,放火罪 
ascot	 アスコットタイ,アスコットスカーフ(副の広い男性用のスカーフ・ネクタイ) 
ashen	 灰の / 灰色の;青白い
aside	 『わきに(へ)』;ある位置・方向から)それて;(…から)少し離れて《+『from』+『名』》 / 別にしておいて,しまっておいて / 忘れて,考慮しないで / (演劇の)傍白,わきぜりふ / ひとり言 / わき道にそれた発言
askew	 斜めに;曲がって,ゆがんで / 曲がって,ゆがんで
aspen	 ハコヤナギ,ポプラ 
aspic	 アスピック(肉・魚・野菜の煮汁から作るゼリー) 
aster	 アスター,エゾギク(庭に植えるキク科の一年草) 
astir	 (…に)わきたって,ざわめいて《+『at』+『名』》;(…で)にぎわって《+『with』+『名』》 / (ベッドから)起きて
atone	 (罪・あやまちなどを)償う,あがなう,埋合せをする《+『for』+『名』》 
atony	 (生体の組織の)無力[症],弛緩(しかん) 
audio	 (電波の)可聴周波の,低周波の;(テレビの)音声の / (テレビの)音声[部門]
audit	 会計検査(監査) / 決算報告[書] / …‘の'会計検査(監査)をする / 《米》(大学の講義)'を'聴講する / 会計検査(監査)をする 
auger	 らせん形のきり(大工用でT字型の柄がついている) 
aught	《古・詩》 何か, 何でも; あらゆること/少しも, どの程度にもせよ/零, ゼロ; 《古》 無
auxin	 オーキシン(植物の成長を調整するホルモン) 
avert	 〈事故など〉'を'避ける,防ぐ / (…から)〈目など〉'を'そらす,そむける《+『名』+『from』+『名』》
avoid	 〈危険・いやなもの〉'を'『避ける』,回避する(keep away from) / (法律上)〈抗弁など〉'を'無効にする
awful	 (光景・事故などが)『恐ろしい』,すさまじい / 《話》(行為が)『ひどい』,見苦しい / 《話》(程度が)大きい,すごい(great) / 《俗》ひどく,すごく(very, extremely)
awoke	 awakeの過去・過去分詞 
axiom	 自明の理,原理;(数学の)公理;格言 
azure	 空色の;青空の(sky-blue) / 空色;《詩》青空,天空(sky)
bacon	 『ベーコン』 
badge	 『記章』,バッジ / 印
badly	 『悪く』,まずく,へたに / 『大いに』,『ひどく』,非常に
bagel	 ドーナツ型堅ロールパン 
bairn	 《スコットランド・北英》子供;むすこ,娘 
baize	 ベーズ(玉突き台などに張る緑色の柔らかい毛織地) 
baker	 『パン屋』,パン焼き職人 
balky	 (馬が)急に止まる癖のある 
balmy	 おだやかな,さわやかな / 芳香のある,かぐわしい / 心の慰めとなる / 《米俗》少し気が変な(《英》barmy)
bandy	 〈ボールなど〉'を'投げ合う,打ち合う / 〈言葉・殴打など〉'を'交わす / =bandy-legged 
banjo	 バンジョー(4弦または5弦の楽器) 
barge	 (運河などの)平底の荷船,はしけ / 遊覧船,屋形船 / …'を'はしけで運ぶ / のろのろ動く,よろよろ動き回る《+『about』(『around』)》
barmy	 愚かな,少し気が変な(《米》balmy) 
baron	 男爵(英国ではviscount(子爵)に次ぐ貴族) / 《米》大実業家,…王
basic	 『基礎の』,基本的な(fundamental) / 塩基性(アルカリ性)の
basil	 〈C〉メボウキ(芳香のある草) / 〈U〉バジル(メボウキの葉…香辛料)
basin	 『たらい』,はぢ(bowl);洗面器 / (…の)たらい1杯[分]《+『of』+『名』》 / (自然または人工の)水たまり,池 / (川の)流域;くぼ地,盆地 / 入江,内湾,船だまり 
baste	 (焼くとき)〈肉など〉‘に'バターをぬる,油(たれ)をかける 
batch	 (パンなどの)一焼き分《+『of』+『名』》 / (…の)1度分の[の分量]《+『of』+『名』》 / 《話》(…の)束;群,組《+『of』+『名』》 
bathe	 《米》〈子供など〉'を'『入浴させる』(《英》bath) / …'を'『浸す』,『洗う』 / 〈汗・涙が〉…'を'ぬらす / 〈光などが〉…‘に'いっぱいに注ぐ,'を'包む / 《米》入浴する《英》bath) / 《おもに英》水泳する / 《英語》(海・川での)水泳 
batik	 ろうけつ染め / ろう染めの布
baton	 (音楽の)指揮棒 / バトンガールが持つバトン / (元帥などの官位を示す)官杖,司令杖 / (リレー用の)バトン / (警官の)警棒 
baulk	 =balk 
bawdy	 みだらな,わいせつな,品のない 
bayou	 《米》(アメリカ南部の)沼地性の入り江 
beach	 『浜』,海岸 / 海水浴場 / 〈ボートなど〉'を'浜に引き上げる 
beady	 ビーズのような;(特に目が)小さく丸く輝く 
beano	 =bingo 
beard	 〈C〉(人の)『あごひげ』 / (動物の)あごひげ;(一般に)ひげ状のもの / …‘に'勇敢に立ち向かう 
beast	 《文》(人間以外の)『動物』,(特に鳥・魚に対して)四足獣;(人間に対する)『けもの』,畜生 / (けもののように)粗暴な人 / 《英話》《~a》(…の)とてもいやなこと(物)《+『of』+『名』》 
beaut	 すばらしいもの(こと) 
beaux	 beauの複数形 
bedim	 (…で)〈目・心など〉'を'曇らせる,かすませる《+『with』(『by』)+『名』》 
befit	 《文》…‘に'適する,ふさわしい,似合う 
befog	 …'を'霧(雲)で包む / (…で)〈問題・論点など〉'を'ぼかす,あいまいにする《+『名』+『with』+『名』》
began	 beginの過去形 
begin	 『始まる,開始する』 / 発生する,起こる / …'を'『始める』,‘に'着手する / …'を'起こす,創始する
begot	 begetの過去形 
begun	 beginの過去分詞形 
being	 〈U〉存在,実在(existence);生命(life) / 〈U〉本質,本性(nature) / 〈C〉生き物 
belay	 〈船のロープ〉'を'綱留め栓に8字形に巻く / 《命令文に用いて》…'を'やめる(stop)
belch	 おくび,げっぷ / (ガス・煙・水などの)噴出;噴火 / …'を'激しく噴出する《+『forth』(『out』)+『名,』+『名』+『forth』(『out』)》 / おくびをする,げっぷが出る
below	 《fly,go,sink など移動を表す動詞と結びつき方向を表して》…『の下方へ』,より低い位置へ / 《位置》…『の下方で』,より低い位置に / (上手・先方に対して)…より下手に,より手前に / (度合・地位・数量などが)…『より以下で』(の) / …にふさわしくない,にさえ値しない / 『下方へ向かって』,低い位置へ / 下方で,低い位置で / (記述で)以下に,下記に / 下級の,下位に / 下記の,後述の
bench	 『ベンチ』,長いす / 〈U〉(職人・技師・科学者の)作業台,実験台,細工台 / 長くて狭い段丘 / 《the~》(スポーツの)選手席,ベンチ;《集合的に》補舌選手たち / 〈C〉裁判官席;〈U〉裁判官の職(地位) / 《集合的に》《the~》裁判官[たち] / 〈C〉(英国議会などの)議席 / 〈選手〉'を'補欠としてベンチに座らせておく
berth	 (船・列車などの)寝台,寝だな / (船舶の)停泊位置,投錨(びょう)地;操船余地 / 《船》職,地位 / 〈船〉'を'停泊させる / 〈人〉‘に'寝台(寝る所)を与える / 停泊する / 寝る所を手に書れる 
beryl	 緑桂石(エメラルドなど) 
besom	 竹ぼうき 
bhang	 インド大麻 / (インド大麻から作る)麻薬,麻酔剤
bidet	 ビデ(女性用局部洗浄器) 
bight	 入り江,小湾 / (海岸線・川岸の)屈曲 / 両端を固定したときの)綱のたるんだ部分;(結んだときにできる)綱の輪 
bigot	 (信仰・主義などに凝り固まった)がんこな迷信家,(人種的)偏見の持ち主 
bijou	 宝石 / 小さくかわいらしい物(場所)
bilge	 〈U〉(船底の)湾曲部 / 〈U〉(船底の)汚水,あか(bilge water) / 〈C〉(たるの)胴 / 〈U〉《話》くだらない話
bimah	 ビーマー(ユダヤ教の会堂内にある朗唱壇) 
binge	 (飲み食いしての)浮かれ騒き,とんちゃん騒ぎ,(何かを)思いきりすること 
bingo	 ビンゴゲーム(数を記したカードで縦・横・斜めに数字を合わせる賭(‘か')けごと) 
biped	 2足ある / 二足動物
birch	 〈C〉カバの木 / 〈U〉カバ材 / (また『birch rid』)〈C〉カバの枝のむち (学童を罰するのに用いる) / …'を'枝むちで打つ,罰する
birth	 〈C〉〈U〉『誕生』,出生 / 〈U〉『生まれ』,家柄;家系(lineage) / 〈C〉『起原』,起こり(origin) 
bison	 アメリカ野牛(buffalo);ヨーロッパ野牛 
bitch	(犬・オオカミ・キツネなどの)雌 / 《俗》性悪(しょうわる)女,あばずれ・嫌な女、意地悪な女、あばずれ、くそばばあ、よく文句を言う女、あま、淫乱な女、尻軽女・嫌なもの、難しいもの、難しいこと、大変なこと・ （反語的に）すごく良いもの、すごく楽しいこと
biter	 かむ人(年);かみつく動物(特に犬) 
black	 『黒い』,黒色の / 『暗い』,まっ暗な(dark) / (特にアフリカ系)黒人の / 汚い(dirty),汚れた(soiled) / 陰気な(gloomy);不吉な;見通しの暗い / 怒った(angry);不きげんな(sullen) / 腹黒い,邪悪な(wicked, evil) / 《文》不名誉な / (コーヒーに)クリーム(牛乳)を入れない,ブラックの / 〈U〉『黒』,『黒色』 / 〈C〉《しばしば『B-』》黒人 / 〈U〉黒衣,(特に)喪服 / 黒くなる;暗くなる / …'を'黒くする;…'を'暗くする(blacken) / (靴墨で)〈靴〉'を'みがく 
blade	 (刀・ナイフ・のこぎり・かみそりなどの)『刃』,刀身 / 刀,剣 / (特にイネ科植物の)葉,葉身 / (一寮に)薄く平べったい部分 / (アイススケート靴の)金属のすべり 
blain	 膿疱(のうほう),水疱,はれもの 
blame	 〈事〉'を'『非難する』,とがめる;(…のことで)〈人〉'を'非難する《+『名』+『for』+『名』(do『ing』》 / (…に)〈罪など〉'を'なすりつける《+『名』+『on』+『名』》 / (罪・過失などに対する)『責任』(responsibility);責め,非難(censure)《+『for』+{名}(doing) 
bland	 (態度などが)物柔らかな,人当たりがいい / (気候など)温和な;(食事など)刺激性のない / 興味のわからない,活気のない 
blank	 (紙が)『白紙の』;(欄が)空白の,書き入れていない / がらんとした,からの(empty);なんの装飾もない / 『ぼんやりした』,うつろな,無関心な / 全くの / 『空白』,空所 / 書き込み用紙(form) / 空虚;空(くう)の部分 / (語句・文学を伏せる場所に用いる)ダッシュ“‐":Mr-某氏 / (またblank cartridge)(銑火器の)空包 / …'を'消す,削除する《+『名』+『out,』+『out』+『名』》 / 《米》〈相手〉‘に'試合で得点させない 
blare	 〈ラッパなど〉'を'鳴り響かせる;…'を'大声で告げ知らせる《+『out』+『名』+『名』+『out』》 / 大きくやかましく鳴り響く / (らっぱ・角笛などの)耳ざわりな響き 
blase	 (楽しいことの見過ぎ・し過ぎで)飽きた,退屈した 
blast	 〈C〉(風の)『一吹き』,一陣の風;突風,疾風《+『of』+『名』》 / 〈C〉(穴から吹き出す空気の)一吹き / 〈C〉(笛・らっぱなどの)突然の大きな[不快な]音《+『of』+『名』》 / 〈C〉〈U〉爆破(explosion)《+『of』+『名』》 / 〈C〉(1回分の)発破,爆薬 / 〈C〉〈U〉爆風 / …'を'『爆破する』;…'を'爆破して作る(開く) / 《文》…'を'孫なう,台なしにする;〈霜などが〉…'を'枯 / 〈らっぱなど〉'を'急に大きく鳴らす / …'を'酷評する;(…について)〈人〉'を'こっぴどく叱る《+『名』+『about』+『名』(do『ing』)》 / …'を'のろう(damn) 
blaze	 〈C〉〈U〉炎,火炎 / 〈C〉〈U〉『強烈な光』,閃光(せんこう) / 〈C〉〈U〉燃え立つような輝き / 《a blaze》(感情・怒り・りの)突然の激発(outburst)《+『of』+『名』》 / 《複数形で》《話》《遠回しに》地貯 / 〈火が〉『明るく』(『あかあかと』)『燃える』 / (…で)〈物が〉燃えるように輝く(光)《+『with』+『名』》 / (ある感情で)燃え上がる,輝く《+『with』+『名』》
bleak	 (場楠が)吹きさらしの,荒涼とした / 寒い,冷え冷えする / (将来のことなど)暗い,陰うつな 
blear	 (涙などで)目がかすんだ,曇った(blurred) / (涙などで)〈目・視力〉'を'かすませる(blur)
bleat	 〈ヒツジ・ヤギなどが〉メーと鳴く / …'を'泣き声で言う / (ヒツジ・ヤギなどの)鳴き声 
blend	 (分離できないほどに)…'を'『混ぜ合わせる』;(…に)…'を'混ぜる《+『名』+『with』+『名』》 / 『混じる』;溶け合う / (…と)『調和する』《+『with』+『名』》(harmonize) / 『混合』,調合;〈C〉『混合物』
blent	 blendの過去・過去分詞 
blest	 《古》《詩》blessの過去・過去分詞 
blimp	 (観測用の)小型軟式飛行船 
blind	 『目の見えない』,盲目の(sightless) / 《補語にのみ用いて》(…を)見る目がない,気がついていない《+『to』+『名』》 / 盲目的な,めくらめっぽうの(reckless) / (特に車の運転者に)隠れて見えない / (通りなどが)行き止まりの,出口のない;(建築物が)窓のない / 肉眼で見えないでする,計器だけに頼る / 〈人〉‘の'目をくらませる,'を'盲目にする / (…に対して)〈人〉‘の'判断力(分別)を失わせる《+『名』〈人〉+『to』+『名』》 / 『日よけ』,すだれ,よろい戸,ブラインド / 人の目をごまかすもの,見せかけ / 《米》(猟師の)隠れ場 / 目が見えなくて
blink	 (無意識に)『まばたきする』 / 〈灯火・星などが〉『明減する』,ぴかぴか光る(twinkle) / (欠点・悪事などを)見て見ぬふりをする《+『at』+『名』》 / (…を見て)目をぱちくりさせて驚く《+『at』+『名』》 / 〈目〉'を'まばたきする / 〈灯火〉'を'点滅させる / …'を'見て見ぬふりをする / またたき / きらめき 
blitz	 =blitzkrieg / 猛烈な空襲 / (一般に)急襲 / …'を'急襲する
bloat	 …'を'ふくれ上がらせる / ふくれ上がる
block	 (木・石などの,通例平らな面のある)『かたまり』 / 《米》(四団を街路に囲まれた)『区画』,街区 / 街区の1辺の距離(一般に40メートル前後) / 《英》ブロック(アパート・事務所・商店などに区切られている大きな建物) / 『妨害物』,障害物(obstacle);(障害によって生じた)停滞,渋滞 / 台木,台(まないた・肉切り台・まき割り台・せり売り台・帽子の木型など);《the~》炭頭台 / (特にアメリカンフットボールで)ブロック(相手の選手の突進を阻止する) / 滑車(pulley) / (座席券・株券などの)一組《+『of』+『名』》 / 〈通路など〉'を'『ふさぐ』,〈通行・進行など〉'を'妨げる / 〈帽子など〉の型取りをする / (特にアメリカンフットボールで)〈相手選手の突進〉'を'ブロックする;(ボクシングで)〈相手のパンチ〉'を'ブロックする
blown	 blowの過去分詞 
blowy	 風のある,風の強い 
bluet	 青い花の咲く植物の総称;ヤグルマソウなど 
blunt	 『切っ先の鈍い』,なまくらの / 『ぶっきらぼうな』,無愛想な / …'を'鈍くする,鈍らせる / なまくらになる,鈍る
blurt	 …'を'なにげなく言う,うっかり口をすべらせる《+『out』+『名,』+『名』+『out』》 
blush	 (当惑・恥ずかしさのために)『顔を赤らめる』,赤面する / 〈C〉(当惑・恥ずかしさによる)『赤面』 / 〈U〉〈C〉赤み,ばら色 
board	 〈C〉(ある程度の長さと幅をもった薄い)『板』 / 〈C〉ボール紙,台紙 / 〈C〉食卓;〈U〉食事,(特に有料の)まかない / 〈C〉甲板(かんぱん),船べり / 〈C〉『委員会』;(官庁の)局,部,課 / 《the boards》舞台 / …‘に'板を張る,'を'板で囲う《+『up』(『over』)+『名,』+『名』+『up』(『over』)》 / …‘に'食事を出す,'を'まかない付で下宿させる / …‘に'乗り込む / (…に)まかない付きで下宿する,食事つきで滞在する《+『at』+『名』〈場所〉,+『with』+『名』〈人〉》
boast	 (…を)『自慢する』,鼻にかける《+『about』(『of』)+『名』(do『ing』)》 / …'を'『自慢する』,鼻にかける / …'を'『誇りとして持っている』,‘が'自慢の種である / 誇り / 『自慢』,自慢話 
bogey	 =bogy / (ゴルフで)ボギー(基準打数(par)より一つ多い打数)
bogie	 =bogy / (また『bogie car』)《英》ボギー者(旋回台でカーブが自然にできるようになっている鉄道車両)
bogus	 にせの,いんちきの 
bolas	 =bola 
bolus	 (動物用の)大きい丸薬 / かみこなれた食物の丸い固まり
boned	 (魚など)骨を取り除いた / (衣服が)(コルセットなどで)骨で張りをつけた[ような]
boner	 へま,大失策 
bonus	 ボーナス,特別手当;特別配当金 / 桂品,おまけ / 《話》思いがけない喜び[を与えるもの] 
borax	 硼砂 
borne	 bearの過去分詞 
bosky	 木の茂った;木陰の多い 
bosun	 =boatswain 
botch	 《話》…'を'ぶかっこうに繕う;…'を'やりそこなう,だいじにする《+『up』+『名』,+『名』+『up』》 / へたな繕い(仕事)
bough	 (木の)『大枝』 
boule	 人造宝石用のとっくり形の原石 
bound	 《副詞[句]を伴って》『はね上がる』,はね飛ぶ,はね返る / 〈心が〉おどる,わくわくする / 『はずみ』,はね返り;『跳躍』 
bowed	 頭を下げた,うなだれた,(重みで)下がった 
bowel	 〈C〉『腸』;《通例複数形で》腹わた,内臓 / 《複数形で》内部,中心部
bower	 《文》木陰 / (庭園内の)あずまや / 《詩》婦人の私室 
bowls	 球ころがし(芝生で行う木球競技) 
boxer	 ボクサー,けん闘家 / ボクサー(ドイツ種の中型犬)
brace	 つっぱり,支柱;かすがい,締め金 / 《複数形で》大かっこ({ }印) / 《複数形で》《英》ずぼんつり(《米》suspenders) / (…の)1対,1つがい(pair)《+『of』+『名』》 / (ドリルの)曲がり柄 / (…にそなえて)〈神経など〉'を'引き締める,緊張させる《+『名』+『for』(『against』)+『名』》 / (…で)…‘に'つっぱりをする,支えをする《+『名』+『with』+『名』》 / …'を'しっかり固定させる
bract	 (植物の)ほう(苞) 
braid	 組みひも,さなだひも;《おもに米》(髪を結ぶ)リボン,バンド / 《おもに米》=plait / 〈U〉モール / 《おもに米》=plait / …'を'組みひも(モール)で飾る 
brain	 『脳』,脳髄 / 《しばしば複数形で》『頭脳』,『知力』 / 《話》秀才,知的指導者 / …‘の'頭を打ち砕く
brake	 『ブレーキ,制動機』,歯止め / …‘に'ブレーキをかける / 〈人が〉ブレーキをかける 
brand	 (商品などの)『種類』,『品質』《+『of』+『名』》 / 『商標』,『銘柄』 / (家蓄・商品などに付けて所有主・品質などを示す)焼き印,焼きごて / (昔罪人に押した)烙印(らくいん);汚名 / 《文》燃えさし / …‘に'焼き印を押す / …‘に'(…という)汚名を着せる,烙印(らくいん)を押す《+『名』[+『as』]+『名』(『形』)》 / (…に)…'を'強く印象づける《+『名』+『on』(『in』)+『名』》
brant	 黒ガン(北極産の黒い渡り鳥) 
brash	 せっかちな,がむしゃらな / 無作法な,厚かましい
brave	 『勇敢な,勇ましい』 / 《文》はなやかな…みごとな / 勇士 / 北市インディアンの戦士 / 〈困難など〉‘に'勇敢に立ち向かう,〈危険〉'を'ものともしない 
bravo	 かっさいの叫び / うまいぞ,でかした
brawl	 騒々しいけんか…大騒ぎ / やかましく口論する,けんかする / 〈川などが〉ごうごうと流れる 
brawn	 (人の)筋肉…筋力 / 《英》煮て塩づけして固めた豚肉(《米》headcheese)
braze	 〈金属〉'を'はんだづけ(ろうづけ)する 
bread	 『パン』,食パン / (生名の糧(かて)として必要な)食物一般…生計・金・銭
break	 …'を'『壊す』,割る,砕く;…'を'折る / …'を'擦りむく / …'を'『役に立たなくする』,壊す / (小さな物に)〈組になった物〉'を'分ける,ばらす,〈お金〉'を'くずす《+『名』+『into』+『名』》 / 〈垣・へいなど〉'を'破って出る / 〈法律・規則・約束など〉'を'『破る』,犯す / 〈均整・秩序・配列など〉'を'破る,くずす;〈持続しているもの〉'を'中止する,妨げる / 〈記録〉'を'破る,更新する / (…に)…'を'打ち明ける,知らせる《+『名』+『to』+『名』》 / …'を'破産させる,倒産させる / 〈気力・抵抗など〉'を'くじく;〈力・効果・強度〉'を'弱める / (…に)…‘の'位を下げる,…'を'降等させる《+『名』+『to』+『名』》 / 〈動物〉'を'ならす / 〈人〉‘の'(…の)癖を直す《+『名』〈人〉+『of』+『名』(do『ing』)》 / 〈暗号など〉'を'解読する;〈事件・問題など〉を解決する,解く / 《しばしば副詞[句]を伴って》『壊れる』,砕ける,割れる;破れる,破裂する / ぷっつりと切れる;中断する,途切れる;《米》仕事を中断する / はずれる,離れる,分離する《+『off』(『away』)》 / 故障する,壊れる,動かなくなる / 突然始まる;突然変化する / 夜が明ける / 〈健康・気力などが〉衰える,弱る;〈心が〉悲しみに打ちひしがれる / 〈株・価格などが〉急落する,暴落する / 壊れた箇所,裂け目,割れ目 / 中断,途切れ;不和,仲たがい / 休憩時間,小休止 / 逃亡計画,脱獄 / (…に向かっての)突進 / 急な変化,顕著な変化 / 夜明け / 《話》運,機会 
bream	 タイ科の海産魚 / コイ科の淡水魚
brick	 〈C〉(1個の)『れんが』 / 〈U〉(材料としての)『れんが』 / 〈C〉(形が)れんがに似た物 / れんがの,れんが造りの / 〈建築物〉を=れんがで囲う,れんがで作る,…‘に'れんがを敷く《+『in』(『on』)+『名』》 
bride	 花嫁,新婦 
brief	 『短時間の』;短期間の(short) / 言葉数の少ない,簡潔な / (弁護士が裁判所に提出する)弁輪趣意書 / 《複数形で》(下着の)ブリーフ / 〈人〉‘に'必要な指示(情報)を与える / …‘を'要約する
brine	 塩水 / 《the ~》《詩》海水;海 / 漬物用の塩水 
bring	 〈物〉‘を'『持ってくる』 / 〈人が〉(…に)〈人〉‘を'『連れてくる』《+『名』〈人〉+『to』+『名』》 / 〈物事が〉(…に)〈人〉‘を'『来させる』,引き寄せる《+『名』+『to』+『名』》 / 〈物事〉をもたらす,引き起こす / (ある状態・結果・動作などに)…‘を'『する』 / (…に対して)〈訴訟〉を起こす《+『名』+『for』(『against』)+『名』》
brink	 (がけ・河岸などの)『緑』 / まぎわ
briny	 塩水の,塩水に似た;塩辛い 
brisk	 (人・動作などが)『きびきびした』,元気のよい / (商況が)活気のある,盛んな / (風などが)身のひきしまるような,さわやかな 
broad	 『幅の広い』 / 『広大な』,広々とした / 幅が…ある / 寛大な,包容力のある,偏見のない / 広範囲にわたる / 分かりやすい,明白な / くまなく行き渡った,さえぎるもののない,明るい / あけすけの,露骨な / 主要な;大まかな,大ざっぱな / (発音に)強いなまりのある / すっかり,広く(wide) 
broil	 《おもに米》〈肉など〉'を'焼く,あぶる / …‘に'照りつける,焼くような熱気を注ぐ / 〈肉が〉焼ける / 激しい暑さにさらされる,焼けつくように暑くなる;ひどい日焼けをする / 焼き肉 
broke	 breakの過去形 / ほとんど(全く)金を持たない,文なしの
broth	 蒲いスープ,(肉・さかなの)煮つゆ 
brown	 『褐色の』,『茶色の』 / 日に焼けた / 『褐色』,『茶色』,トビ色 / …'を'褐色にする / 褐色になる 
bruin	 クマ君(童話の中で擬人化されたクマ) 
bruit	 《うわさなど》'を'言いふらす 
brunt	 (功撃の)主力,ほこ先 
brush	 『ブラシ』,『はけ』,毛筆,画筆 / ブラシをかけること;絵筆を使うこと,画法 / ブラシに似た物;キツネのしっぽなど / 小ぜり合い,いざこざ / (…が)さっとかすること《+『of』+『名』》 / (モーターの)ブラシ,刷子 / …‘に'『ブラシをかける』,'を'ブラシでこする(みがく,払う) / (ブラシをかけるようにして,手で)…'を'払いのける / (通りすがりに)…'を'さっとかする / (…を)かすめて通る,かする《+『past』(『by』,『against』)+『名』》
brute	 『けもの』,動物,畜生 / 《時に軽べつして,時におどけて》『けもののような人』,人非人 / 理性のない,動物的な / (けもののように)粗暴な,野卑な
budge	 《won't, wouldn'tと共に》ちょっと動く / 《can't, couldn'tと共に》…'を'ちょっと動かす
bugle	 軍隊らっぱ / らっぱを吹く
build	 〈物〉'を'『組み立てる』,造る,建造する,建築する / (年月をかけて)〈事〉'を'『作り上げる』,築き上げる;《受動態で》〈体・性質〉'を'作る / 〈U〉造り,講造(make) / 〈U〉〈C〉体格
built	 buildの過去・過去分詞 / 「(体が)…にできている,…造りの」の意を表す
bulge	 ふくらんだ部分,ふくらみ / (…で)ふくらむ,張り出す《+『out』 『with』+『名』》 / 'を'ふくらませる《+『of』+『名,』+『名』+『名』+『out』》 
bulgy	 ふくらんだ 
bulky	 かさばった,ばかに大きい / 扱いにくい
bumpy	 (表面が)でこぼこの / (車などが)がたがた動揺する
bunch	 (…の)『ふさ』(cluster),束《+『of』+『名』(複数)》 / 《話》(…の)群れ《+『of』+『名』(複数)》 / 一団(束)になる《+『up』》 / …'を'束(ふさ)にする
bunco	 いかさま,ぺてん 
bunko	 いかさま,ぺてん,かたり 
burgh	 《スコットランド》自治都市 
burly	 たくましい,がんじょうな 
burnt	 burnの過去・過去分詞 / 焼けた;焦げた;やけどした
burst	 『破裂する』,爆発する / 〈つぼみが〉ほころびる / 《通例進行形で》(…で)はちきれそうにいっぱいである《+『with』+『名』》 / 『急に(…)する』 / …'を'破裂させる,爆発させる,破る / (…の)『破裂』,爆発《+『of』+『名』》 / (…の)『突発』《+『of』+『名』》 
bushy	 低木のおい茂る / 毛深い,ふさふさした
butch	 (特に女性が)男っぽい / (英俗)（女性の同性愛の)男役の女性 / 短い角刈りに似た髪型 
buxom	 (女性の)胸が豊かな;(女性が)健康で快活な 
buyer	 買い手,購入者 / (小売店などの)仕入れ係,バイヤー
bylaw	 (協会・団体・会社などの)内規,付則,細則 
caber	 (力試しの競技で投げる)木の柱 / 柱投げ競技
cabin	 (通例,木造1階建ての)『小屋』 / 『船室』;(飛行機の)客室
cable	 〈C〉〈U〉 / (麻・針金をより合わせた)『太綱』 / 〈C〉〈U〉 / (電信などの)『ケーブル線』,被覆電線 / (またcablegram)〈C〉『海底電信』,外国電報 / …'を'太綱でつなぐ / …‘に'を敷く / 〈通信〉'を'『海外電報で送る』
cadet	 士官学校生徒,士官候補生 / (一般職の)見習 / 次男以下の息子 
cadge	 …'を'ねだる,せびり取る / ねだる,せびる / 物乞い,ねだり 
cadre	 (組織の中核をなす)幹部集団,中核グループ 
cager	 バスケットボール選手 
cairn	 ケルン(道標・記念碑として積み上げた石) 
calif	 =caliph 
calve	 〈雌牛が〉子を産む / 〈氷河・氷山などが〉一部分離する
calyx	 (花の)がく(萼) 
camel	 『ラクダ』 / =caisson2
cameo	 カメオ(浮き彫りをしためのう・貝殻などの装飾品) / 少量の,小規模の
campy	 風変わりな,気取った,芝居がかった 
candy	 《米》『砂糖菓子』,キャンデー(《英》sweets) / 《英》氷砂糖(sugar candy) / …を砂糖づけにする　砂糖で煮る / (煮つめて)…'を'結晶させる / …'を'甘くする / 氷砂糖状に固まる
canoe	 『カヌー』,丸木舟 / カヌーで行く / 〈湖など〉'を'カヌーで渡る / 〈物〉'を'カヌーで運ぶ
canst	 《古》canの二人称単数現在形 
canto	 長詩の大きな一区分(散文のchapterにあたる) 
caper	 はね回る,ふざける / はね回り / 《しばしば複数形で》《話》悪ふざけ 
capon	 去勢した食肉用おんどり 
caret	 (校正の)脱字符号 
cargo	 (船・飛行機の)『積荷』,貨物 
carny	 旅芸人 / =carnival3
carob	 イナゴマメ(地中海沿岸産の豆に似た実のなる木) / イナゴマメの実
carol	 祝いの歌,喜びの歌,賛歌 / 祝歌を歌う / 楽しく歌う,喜び歌う《+『away』》 / …'を'祝歌で祝う
carve	 …'を'『刻んで作る』,彫る,彫刻する / (食べやすいように)〈肉〉'を'切り分ける / 肉を切り分ける 
caste	 カースト(僧侶・士族・平民・どれいの4階級からなるインドの世襲的階級) / 世襲的な社会階級[制度] / 世襲による社会的地位(身分) 
cater	 (結婚式・パーティーなどで)(…の)食物を調達する,料理をまかなう《+『for』(『to』)+『名』》 / (…の)要求を満たす,用命に応じる《+『for』(『to』)+『名』》 / 〈結婚式・パーティーなど〉‘の'料理をまかなう,仕出しをする 
caulk	 〈継ぎ目〉‘に'アスファルト(麻くずなど)をつめる 
cause	 〈U〉『原因』,起因;〈C〉原因となる人(物事) / 〈U〉『正当な理由』,根拠,動機 / 《the~》(…という)(身を捧げるべき)主義,主張,目的《+『of』+『名』》 / 〈U〉〈C〉訴訟[の理由];申し立て / …'を'『原因となる』,'を'引き起こす,もたらす(bring about) 
cavil	 (…に)やたらにけちをつける,(…の)あらを捜す《+『at』(『about』)+『名』》 / あら捜し,揚げ足取り
cedar	 ヒマラヤスギ,セイヨウスギ;〈U〉杉材 
chafe	 …'を'こすって暖める / …'を'こすってすりむく / …'を'いらだたせる,じらす / (…で)すりむける,すり切れる;すりむいて痛む《+『from』+『名』》 / すり傷 
chain	 『鎖』;(装飾用の)鎖 / 《複数形で》『束縛』,拘束;囚人をつなぐ鎖 / (物事の)『連続』,つながり《+『of』+『名』》 / (商店・銀行・ホテルなどの)チェーン(一連の店が同一資本のもとで連携して経営される方式;その店) / チェーン(測量で用いられる単位;約21.7m) / …'を'『鎖でつなぐ』《+『up』(『together』)+『名,』+『名』+『up』(『together』)》
chair	　〈C〉『いす』(通例1人用の4脚で背のあるもの;armchair, easy chair, rocking chair, swivel chairも含めていう)/ 《the chair》権威のある座(教授・裁伴官・司教・知事・市長などの地位) / 《the chair》議長(chairperson) / 《the chair》《米》(死刑用の)電気いす / …‘の'議長をつとめる,'を'司会する / …'を'いすに座らせる 
chalk	 『チョーク』,白墨(はくぼく) / 〈U〉白亜,チョーク(白自で柔らかく,粉末になりやすい石灰岩) / 〈C〉チョークでつけた印,チョークでかいた絵 / …'を'チョークで書く(印をつける) / …‘に'チョークで塗る(こする),チョークで白くする 
champ	 …'を'むしゃむしゃ(ボリボリ)食べる / 〈馬が〉〈くつわのはみ〉'を'バリバリかむ / むしゃむしゃ食べる / くつわをかむ
chant	 〈C〉(単調なリズムで繰り変される)歌 / (一つの音で単調に歌われる)詠唱 / (詠唱調で歌われる)聖歌 / …'を'丹調に繰り返して歌う(叫ぶ) / …'を'詠唱する / (一般に)…'を'歌う / 丹調に繰り返して歌う(叫ぶ) / 詠唱する;聖歌を歌う
chaos	 〈U〉(天地創造以前の)混とん / 〈U〉(一般に)『混乱状態』,無秩序;〈C〉混乱したもの
chaps	 カウボーイがズボンの上からはく皮ズボン 
chard	 〈C〉フダンソウ(大きな根と葉を持つ食用植物) / 〈U〉(食用の)その葉と茎
charm	 〈U〉〈C〉(人の心を引きつける)『魅力』;《複数形で》女の魅力 / 〈C〉(…よけの)『まじない』,じゅ文,お守り《+『against』+『名』》 / 〈C〉(時計の鎖などにつける)小さな飾り物 / 《しばしば受動態で》…'を'『魅哀する』,うっとりさせる(fascinate),喜ばせる / …‘に'魔法をかける(bewitch);…'を'魔法をかけたようにする 
chart	 『海図』,水路図 / 『図表』 / …'を'図表(海図)に作る / 《話》〈行動など〉'を'計画する(plan)
chary	 用心深い,細心な;(…に)用心深い《+『of』+『名』(do『ing』)》 / 遠慮がちな,つつましい / 《補語にのみ用いて》(…を)出し惜しむ,しぶしぶ(…)する《+『of』(『in』)+『名』(do『ing』)》 
chase	 〈C〉『追跡』,追撃;追求 / 《the ~》狩猟 / 〈C〉追われる人(動物,船,飛行機) / 〈人・動物など〉'を'『追いかける』,追跡する / (…から)〈人・動物など〉'を'『追い払う』,追い出す《+『名』+『from』(『out of』)+『名』》 / (…を)追う,追跡する《+『after』+『名』》 / 《話》走り回る《+『about』》,(…を)走り回る《+『about』+『名』》 
chasm	 (地面・岩などの)大きな深い裂け目(割れ目) / (感情・意見などの)隔たり,みぞ
cheap	 『値段が安い』,料金が安い,安く売る / 『安っぽい』,安物の,質の悪い,価値のない / 下品な,野卑な / 簡単に手に入る / 《おもに米》(人が)けちな,けちくさい(stingy) / 安く / 安っぽく 
cheat	 〈人〉'を'『だます』,欺く / 《文》…'を'うまくのがれる / (…で)〈人が〉『不正をする』,カンニングする《+『at』(『on, in』)+『名』》 / 《話》(浮帰などで夫または妻を)裏切る《+『on』+『名』》 / 〈U〉〈C〉詐欺,ぺてん / 〈C〉ずるいやつ,詐欺師,やま師
chela	 (エビ・カニ類の)はさみ 
chest	 (ふた付きのじょうぶな)『大箱』,ひつ / 《米》たんす(=chest of drawers) / (…の)たんすいっぱい《+『of』+『名』》 / 『胸[部]』,肺
chewy	 ねばっこくてかめない 
chide	 …'を'たしなめる,叱る / たしなめる,叱る
chief	 (組織・集団の)『長』;長官,局(部,課)長;(部族の)長 / 『最高位の』,長である / 『最も重要な』,おもな(most important; main) 
child	 (おとなに対して)『子供』,幼児,児童;(小学・中学・高校の)児童 / (親に対して)子,子孫;息子,娘 / (ある環鏡・時代の)影響を受けて生まれた人,(…の)申し子《+『of』+『名』》 / (頭脳・空想などが)産み出したものの,所産《+『of』+『名』》
chime	 《複数形で》(一組の)『鐘』(さまざまな音階の音を組み合わせた鐘楼の鐘,玄関のチャイムなど) / 《複数形で》チャイム(鐘の組み合わせによる楽器) / 〈C〉チャイムによる音(音楽);チャイムを鳴らしたような音 / 〈U〉〈C〉《文》調和,一致 / 〈鐘・チャイム〉'を'『鳴らす』 / …'を'鐘を鳴らして告げる / …'を'声をそろえて言う / 〈鐘・チャイムが〉鳴る / (…と)調和する《+『with』+『名』》 
chimp	 =chimpanzee 
china	 『磁器』(porcelain) / (また『chinaware』)《集合的に》『陶磁器』,瀬戸物
chine	 背骨 / (料理用の)肉付きの背骨
chink	 チリン,カチン(ガラス・金属がぶつかる音) / 〈金属やガラス〉'を'チリンと鳴らす / チリンと鳴る 
chino	 〈U〉あや織り綿布(制服用などのじょうぶな布) / 《通例複数形で》あや織り綿布製のズボン
chirp	 『チュッチュッ,チッチッ』(虫・小鳥などの鳴き声) / 『チュッチュッ』)『チッチッ』)『と鳴く』《+『away』》 / かん高い声で話す,にぎやかに話す / …'を'かん高く話す
chive	 エゾネギ(サラダに用いる) 
choir	 《集合的に》(教会の)『聖歌隊』,(一般に)合唱団 / 《単数形で》教会の聖歌隊席
choke	 …'を'『息を止める』,'を'窒息させる / (…で)…'を'むせさせる,息苦しくする《+『名』+『with』(『by』)+『名』》 / (…で)…'を'いっぱいにする,ふさぐ,(…を)…‘に'ぎっしり詰める《+『名』+『up』(+『up』+『名』)+『with』+『名』》 / …'を'進行(動き)を止める / 『息が詰まる』,窒息する / (…で)むせぶ,息苦しくなる《+『with』+『名』》 / 〈U〉〈C〉窒息,息が詰まること / (パイプの中などの)閉塞(へいそく)部 / 〈C〉(電気器具の)チョークコイル / 〈C〉チョーク(ガソリンエンジンの空気調整装置)
choky	 監獄 
chord	 (楽器の)弦 / 感情,情緒 / 和音,コード / =cord4 / 弦(数学で,円周上の2点を結ぶ直線) 
chore	 (家庭や農場の)雑用,毎日のきまりきった仕事 / (きまりきっていて)つまらない仕事
chose	 chooseの過去形 
chump	 《俗》ばか / 短く厚い木切れ / (また『chump chop』)厚切りの骨付き肉 
chunk	 (…の)厚切り,厚いかたまり《+『of』+『名』》 / かなりの量(額,部分)
churl	 無作法者 / いなか者
churn	 かく乳器(クリームやミルクをかき老ぜてバターを作る) / 〈クリーム・ミルク〉'を'かく乳器に入れてかき混ぜる / 〈バター〉'を'かく乳器で作る / …'を'激しくかき混ぜる《+『名』+『up,』+『up』+『名』》 / 激しく動く 
chute	 シュート(物を送る傾斜した,または垂直の管・樋(とい)など) / 急流,滝 / 《話》=parachute 
cider	 《おもに米》シードル(通例りんごジュースの意に用いる) / 《おもに英》りんご酒(=hard cider)(りんご汁を発酵させたもの)
cigar	 『葉巻きたばこ』,シガー 
civet	 〈U〉麝香(じゃこう)(ジャコウネコから採る香水の原料) / 〈C〉(またcivet cat)ジャコウネコ
claim	 〈人が〉(当然の権利として)…'を'『要求する』,『請求する』,'を'自分の物だと主張する;(…から)…'を'要求する《+『名』+『from』+『名』》 / 〈人が〉…‘と'『主張する』,断言する / 〈物事が〉…'を'品要とする,‘に'値する / (…に対して…の)権利を主張する《+on(for)+名+against+名》 / 〈C〉(…に対する)(当然の)『要求』,請求《+for(to)+名》 / 〈C〉主張,断言,公言 / 〈U〉(物事を)要求する権利(資格),請求権《+『to』+『名』〈物事〉》;(人に)要求する権利《+『on』+『名』〈人〉》 / 〈C〉請求物;(特に入植者に与えられる)一区画の土地;(鉱業権などの設定された)払い下げ精求地
clamp	 かすがい,締めくぎ,万力 / {動}〈他〉 / …'を'かすがい(万力など)で締めつける 
clang	 (鐘・よろい・金づちなどの)カーン(ガーン,ガチン)という音 / …'を'カーン(ガーン,ガチン)と鳴らす / カーン(ガーン,ガチン)と鳴る 
clank	 (重い金属などがぶつかって鳴る)ガチッ(ガチャッ,カチン,ガチャリ)という音 / …'を'ガチャッ(ガチャガチャ)と鳴らす / ガチャッ(ガチャガチャ)と鳴る 
clash	 (物がぶつかり合う)『ガチャン』)『ガシャン』,『ジャーン』)『という音』 / (…間の)(意見・利害などの)衝突,抗争《+『between』+『名』》 / 『ガチャン』)『ガシャン』)『と音を立てる』;(…に)ガチャンとぶつかる《+『to』(『against, into』)+『名』》 / (…と)『合わない』,調和しない《+『with』+『名』(do『ing』)》 / (競技・戦闘で)(…ど)相打つ,激突する《+『with』+『名』》 / …'を'ガチャン(ジャン)とぶつける
clasp	 (通例金属製の)『留め金』,尾錠,締め金 / (手を)『握り締めること』《+『of』+『名』》 / …'を'留め金で留める / …'を'握り(抱き)締める
clave	 cleaveの過去形 
clean	 『汚れのない』,『清潔な』 / 使っていない / 不純物がはいっていない,純粋な(pure) / 清らかな,潔白な / ゆがみのない,すっきりした / 公正な(fair),規則に従った / 空白の;書き入れてない / 完全な,全くの / 鮮やかな,みごとな / 放射能のない / 完全に,全く,すっかり(completely, entirely) / きれいに / …'を'『きれいにする』 / …'を'取り片付ける / 〈肉・魚・野菜など〉'を'下ごしらえをする / きれいになる;きれいにする / ふき取り掃除 
clear	 『晴れた』;明るい(bright) / 『透き通った』,透明な / (形・輪郭などが)『はっきりした』,くっきりした / (音が)はっきり聞こえる(聞き取れる) / 『分かりやすい』,あいまいさのない / 《補語にのみ用いて》はっきり知っている,確信している / 明せきな,理路整然とした / 妨害(支障)のない / 汚れ(しみ,きず)がない / 《補語のみ用いて》(…を)免れた,(…が)ない,(…から)解放された《+『of』+『名』》 / 《名詞の前,時に名詞の後に用いて》丸々の;正味の / はっきりと,明瞭に,明確に / (…から)離れて《+『of』+『名』》 / 全く,まるまる / (…を)…‘から'『取り除く』,片付ける;(人を)…‘から'立ち去らせる《+『名』+『of』+『名』》 / (…から)〈物〉'を'『取り除く』,片付ける;(…から)〈人〉'を'立ち去らせる《『名』『+『from』(『out of』,『off』)+『名』》 / 'を'きれいにする,清らかにする;…を明るくする / …‘に'触れないで越す / (罪・疑い・責任などから)…'を'逃れさせる』,免除する《+『名』+『of』+『名』》 / 〈議会・税関・手形交換所など〉'を'すんなりと通過する,‘の'許可を簡単に得る / 《話》…'を'まるまるもうける,‘の'純益を上げる / 〈負債〉を清算する,〈手形〉を釧済する;〈小切手〉を現金化する / 『明るくなる』;澄む / 消え去る,過ぎ去る / (じゃま物のない)開けた場所,あき地 
cleat	 耳形の綱止め / (すべり止めに用いる)くさび形の木片(鉄片) / 《複数形で》(靴の裏底・かかとにつける)すべり止め 
cleft	 cleaveの過去・過去分詞 / (地面・岩などの)裂け目,割れ目,ひび
clerk	 (銀行・会社の)行員,社員;事務員 / (官庁の)『書記』,事務官,吏員;(教会の)書記 / 《米》『店員』,売り子(=salesclerk)(《英》shop assistant) / 事務員(書記など)として働く
climb	 …'を'『よじ登る』,登る《+『up』+『名』,+『名』+『up』》 / (…に)『よじ登る』,登る《+[『up』]『to』+『名』》 / 《副詞[句]を伴って》はうように進む / 『上がっている』,上昇する《+『up』》 / 〈つるなどが棒壁などを〉つたい登る《+『up』+『名』》 / 『よじ登ること』,登り;登る所
clime	 clmate1,2 
cline	 (生物の)連続変異(変差) 
cling	 『くっつく』,くっついて離れない;(…に)くっつく《+『to』+『名』》 / (…を)つたって進む《+『to』+『名』》 / (…に)『執着する』,固執する《+『to』+『名』(a person's do『ing』)》 
clink	 (硬貨・グラスなどの)チン(チリン,カチン,カラン,)という音 / チン(チリン)と鳴る,カチンという音が出る / …'を'チン(チリン,カチン)と鳴らす 
cloak	 『そでなし外とう』,マント / 口実,仮面 / …‘に'外とうを着せる / …'を'おおい隠す,装う
clone	 クロン(一個体から無性生殖で増殖した有機体群);(植物の)栄養系,(動物の)分技系 
close	 …'を'『閉じる』,閉める(shut) / …'を'ふさぐ(fill) / 〈事務・仕事・話など〉'を'『終える』,済ませる / 〈通路・施設など〉'を'一時的に閉じる,‘の'使用を一時中止する / (一つにまとまるように)…'を'つめる / 〈ドア・目・花などが〉『閉じる』,閉まる;ふさがる / 〈話・相談・契約などが〉『終る』,終了する,〈店などが〉終業(休業)する / くっつく,接近する(come together) / 終結,結末,終り(end) / 締め切り / (音楽の)終止 
cloth	 〈U〉『布』,生地,織物 / 〈C〉(特定の用途に応じる大きさの)『布地』;(特に)テーブル掛け(table cloth),ふきん(dishcloth),ぞうきん(duster) / 〈U〉布表紙,クロース / 〈U〉ラシャ / 〈C〉黒の聖服;《文》《the~》聖職 
cloud	 『雲』 / (…の)『雲状のもの』《+『of』+『名』》 / (昆虫・鳥・飛行機などの)大群,大集団《+『of』+『名』》 / (疑惑・苦悩などの)暗い影《+『of』+『名』》 / (鏡・ガラスなどの)くもり / 〈煙などが〉…'を'『曇らせる』 / 〈事件などが〉…‘に'暗い影を投げかける,'を'汚す / 〈物・事が〉〈心・頭など〉'を'ぼんやりさせる,混乱させる / 〈空・ガラスなどが〉『曇る』《+『over』(『up』)》 / (悩み・心配などで)〈顔などが〉曇る,暗くなる《+『over』 『with』+『名』》
clout	 〈C〉《話》手でなぐること / 〈U〉《米話》政治的景響力,実力 / …'を'手でなぐる 
clove	 チョウジの木(熱帯産の常緑高木) / チョウジの干したつぼみ(香料用)
clown	 (サーカスなどの)道化,道化役[者] / (集団の中の)おどけ者 / 道化役をする おどける 
clump	 木立ち,やぶ,茂み / (土などの)かたまり;(人などの)集団,(細菌の)群がり《+『of』+『名』》 / 《副詞[句]を伴って》ドスンドスンと歩く / 〈細菌などが〉群がる《+『together』》 / …'を'群がらせる,かたまりにする 
clung	 clingの過去・過去分詞 
clunk	 (物がぶつかり合ったときのにぶい)ガーン(ゴツン)という音 
coast	 『海岸』,沿岸;海岸地域 / 《the C-》《話》(米国の)太平洋岸[地方],西海岸(West Coast) / (そりなどで滑る)斜面;斜面滑降 / (そりなどで)斜面を滑降する《+『along』》;(…を)滑降する《+『along』+『名』》 / 〈人が〉らくらくと(…を)する《+『through』+『名』》 / 海岸沿いに航行する / …‘の'海岸沿いに航行する 
coati	 ハナグマ(熱帯アメリカに住むアライグマ類の肉食動物) 
cobra	 コブラ(アジア産の毒蛇) 
codex	 (古典・聖書の)写本 
comer	 来る人,来た人 / 《おもに米話》将来有望な人(物)
comet	 『慧星』,ほうき星 
comfy	 =comfortable 
coney	 =cony 
conga	 コンガ,キューバの踊り;その曲 / コンガの演奏に用いる縦長のドラム
conge	 (公株の)退去 / (突然の)免職,解任
copra	 コプラ(ココヤシの胚乳を乾燥したもの) 
copse	 =coppice 
coral	 〈U〉サンゴ / 〈C〉サンゴ細工 / 〈U〉サンゴ色,深紅色 / サンゴ[製]の / サンゴ色の,深紅色の 
corgi	 コーギー犬(短足・銅長の小型犬) 
corky	 コルクの[ような] / 《俗》元気のよい,浮かれた
corny	 陳腐な,古くさい;お涙ちょうだいの 
corps	 《しばしばC-》『軍団』,兵団(2個以上の師団(division)から成る陸軍部隊) / 《しばしばC-》(特別な職務を与えられた)部隊 / 団体 
corse	 =corpse 
costa	 肋(ろっ)骨;肋骨状の部分 
cough	 〈C〉『せき』,せき払 / 《a ~》よくせきの出る病気 / 『せきをする』,せき払いする / せきのような音を出す / …'を'せきをして吐き出す《+『up』(『out』)+『名,』+『名』+『up』(『out』)》 
could	 conの過去形 / 《直説法過去》 / 《能力》…『することができた』 / 《潜在的傾向》…することがあった / 《従節でcanのすべての用法における時制の一致》 / 《仮定法》 / 《従節で》a)《現在の事実の反対》…『できる[ならば]』:b)(《過去の事実の反対》…『できていた[ならば]』 / 《主節で》a)《現在の事実の反対》…『できるだろうに』:b)《過去の事実の反対》…『できただろうに』 / 《控え目な表現・丁寧な表現》a)《可能性・推量》(平叙文で)もしかすると…かもしれない;(否定文で)…のはずがないのだが;(疑問文で)いったい…かしら:b)《許可の要請》(疑問文で)…してもよいでしょうか:c)《依頼》(疑問文で)…してくださいませんか 
count	 (一つ一つ順に)〈数〉'を'『数える』,〈物〉'を'数え上げる《+『up』+『名,』+『名』+『up』》 / …'を'『勘定に入れる』,含める(include) / …'を'『思う』,みなす(consider) / 数を数える,計算する《+『up』》 / 数にはいる,数に含まれる / 価値がある,重大である / 〈C〉〈U〉『数えること』,『計算』 / 〈U〉総数,総計 / 〈U〉(起訴状の)訴因 / 《the~》(ボクシングで)カウント(選手がノックダウンされたときレフリーが1から10まで数えること) / 〈C〉(野救で打者の)ボールカウント / 〈U〉《話》考慮,注目(account)
coupe	 クーペ型自動車(2‐6人乗りの二つドア自動車) 
court	 (またcourtyard〈C〉(建物や壁に囲まれた)『中庭』;中庭式の区画 / 〈C〉(テニス・バスケットボールなどの)『コート』 / 〈C〉(場末の)路地,袋小路 / 〈C〉〈U〉《しばしばC-》『宮廷』,皇居;《集合的に》廷臣たち / 〈C〉〈U〉『法廷』,裁判所(court of justice);裁判,公判(trial) / 《the~》《集合的に》裁判官,判事 / 〈U〉《まれ》求愛,言い寄り;きげんとり,追従 / 〈有力者など〉‘の'きげんをとる;〈女〉‘に'求愛する / 〈賞賛など〉'を'求める,得るように努める / 〈災いなど〉'を'招く〈男女が〉仲よくする
coven	 魔女の集会 
cover	 (…で)…‘の'『表面をおおう』,'を'包む,かぶせる《+『名』+『with』+『名』》 / (範囲が)…‘に'『及ぶ』,わたる,'を'取り扱う範囲に入れる / 〈ある距離〉'を'行く,進む(受動態にできない) / …‘に'保険を掛ける / …'を'報道する,取材する / 〈要塞・砲などが〉'を'制圧する / (ピストルなどで)〈人〉'を'ねらう《+『名』+『with』+『名』》 / (球技などで)〈相手〉の動きなど〉'を'ふせぐ;〈地域など〉'を'守る / (…の)代役をする,身代りをする《+『for』+『名』》 / 〈C〉『おおい』,包むもの,カバー;ふた / 〈C〉『表紙』 / 〈U〉隠れ場所,潜伏所 / 〈U〉姿を隠してくれるもの(暗闇,煙など) / 〈C〉(秘密を隠すための)見せかけ / 〈U〉(…の)保険《+『against』+『名』》 / 〈C〉封筒;(郵便小包などの)包装紙 / 〈C〉毛布,ふとん 
covet	 〈他人の物など〉'を'むやみに欲しがる 
covey	 (ウズラ・雷鳥など親子が群居する)鳥の小さな群れ / (人・物の)群れ《+『of』+『名』》
cower	 (恐れ・恥ずかしさ・寒さなどのために)すくむ,ちぢみ上がる,震え上がる 
coypu	 コイプー(南アメリカ産の川ネズミ;その毛皮は高価) 
cozen	 〈人〉'を'だます 
craft	 〈U〉『技能』,技巧 / 〈C〉手先の技術を要する仕事;工芸 / 〈C〉《集合的に》同業者;同業組合 / 〈U〉(悪い意味で)巧妙さ,悪だくみ / 《集合的に》船,飛行機,宇宙船 / …'を'手作りで作る,手作りのように丹念に作る
crake	 クイナ類の鳥の総称 / その鳴き声
cramp	 〈U〉〈C〉(筋肉の)けいれん,こむらがえり / 《複数形で》急激な腹痛 / …‘に'けいれんを起こさせる 
crane	 ツル(鶴) / 起重機,クレーン / 自在かぎ / (よく見ようとして)〈首〉'を'伸ばす / 首を伸ばす 
crank	 クランク(往復直線運動を回転運動に変えるもの) / 《話》変わり者,奇人 / 《米話》気むずかしい人 / 〈軸〉'を'クランクで回す / 〈エンジン・映画のカメラなど〉'を'クランクを回して動かす 
crape	 =crepe 
craps	 (2個のさいころを用いた)サイコロばくち 
crash	 『ガラガラ』,『ドシン』(物が倒れたり砕けたりするときの音) / (飛行機の)『墜落』;(車の)『衝突』 / (事業・相場などの)崩壊,破産 / 『ガチャン』(『ドシン』,『ガラガラ』)『と大きな音をたてる』 / (…に)ガチャン(ドシン)と衝突する《+『into』(『against』)+『名』》 / 大きな音をたてて動く / 〈飛行機が〉墜落する / 〈事業などが〉つぶれる / (…にぶつけて)…'を'『ガチャン』(ドシン),『ガラガラ』)『と壊す』《+『名』+『against』(『into, to』)+『名』》 / 〈飛行機・車など〉'を'衝突させる / 《話》(またgatecrash)(招待状・切符なしで)…‘に'押し掛ける・もぐり込む / 応急の
crate	 (果物・ガラス器具・家具などの運送・荷造りに用いる)わく箱,竹かご / …'を'わく箱(竹かご)に詰める
crave	 〈人が〉…'を'『切望する』,ほしがる / 〈物・事情が〉…'を'必要とする / (…を)『切望する』《+『after』(『for』)+『名』》 
crawl	 (腹ばいで)『はう』,はって進む / 〈人・乗物・時間・仕事などが〉『のろのろと進む』 / (はい回む虫などで)うじゃうじゃしている,うようよしている《+『with』+『名』》 / (虫がはっているかのように)むずむずする / 《話》(人に)取り入る《+『into』+『名』》 / 《a ~》はうこと;のろのろ歩き,徐行 / 《通例the ~》クロール泳法 
craze	 (…で)〈人〉‘の'気を狂わせる《+『名』+『by』(with)+『名』(do『ing』)》 / (…に対する)一時的な熱中(流行)《+『for』+『名』》
crazy	 『狂気の』,気違いの / (物事が)『途方もない』,実行不可能な / 《補語にのみ用いて》『熱中している』,夢中の 
creak	 キーキー鳴る,きしる / キーキーという音
cream	 〈U〉『クリーム』(牛乳の上部に沙まる脂肪分) / 〈C〉〈U〉『クリーム菓子』,クリーム製食品,クリーム状の食品 / 〈C〉〈U〉『化床クリーム』;クリーム状の薬品 / 《the cream》(…の)最上の部分,真髄,粋《+『of』+『名』》 / 〈U〉クリーム色 / 〈牛乳〉‘から'クリームをとる / …'を'クリーム状にする / 〈野菜・乳〉'を'クリーム(または牛乳)で煮る
credo	 《the Credo》=the Apostles' Creed / 〈C〉=creed 3
crept	 creepの過去・過去分詞 
crest	 (鳥の)とさか / (かぶとの)前立て,羽根飾り / 山頂,尾根;波がしら;(一般に)絶頂,最上 / 紋章,家紋
cried	 cryの過去・過去分詞 
cries	 cryの三人称単数現在形 
crime	 〈C〉(事律上の)『犯罪』,罪 / 〈U〉(一般に)犯罪[行為] / 〈C〉《a~》『よくない行為』,ばかげた行為 
crimp	 〈髪など〉'を'縮らせる;〈布〉‘に'ひだをつける / ひだ / 《複数形で》縮れ毛 
crisp	 (また『crispy』)(菓子・揚げものなどが)『かりかり』(『ぱりぱり』)『した』;(野菜などが)新鮮でぱりぱりした;(紙などが)パリパリと音のする / (空気・天候が)+さわやかな』,身の引き締まるような / (動作・返答・表現などが)『てきぱき』(『きびきび』)『した』 / (毛が)縮れた(curly) / 〈毛など〉'を'縮らせる / 〈パンなど〉'を'かりかりに焼く / 〈毛などが〉縮れる / かりかり(ぱりぱり)になる / =potato chip 
croak	 (蛙・烏などの)カーカー(ガーガー)という鳴き声;(人の)しわがれ声 / (蛙・烏などが)カーカー(ガーガー)と鳴く / (不吉な感じで)しわがれ声で話す / (特に)〈不満なこと〉'を'低いしわがれ声で話す
croft	 (屋敷続きの)小農園;(家畜数頭を飼育する程度の)小牧場 / (小さな)小作地
crone	 しわくちゃばばあ 
crony	 親友,旧友,仲よし(chum) 
croup	 クループ(せきや呼吸困難を伴う小児病) 
crowd	 (秩序・統制のない)(…の)『群衆』,人こみ《+『of』+『名』》 / 《the+》『一般大衆』,庶民 / (…の)たくさん寄り集まっているもの《+『of』+『名』》 / 《話》(特定の)グルーパ,連中 / 『群らがる』,大勢集まる / 《副詞句を伴って》群らがって押し進む(押し寄せる) / (…に)〈人・物〉'を'『詰め力む』,押し力む《+『名』+『into』+『名』》 / (…で)〈場所〉'を'いっぱいにする,(…を)…‘に'詰め込む《+『名』+『with』+『名』》 / 《話》せがむ,強要する 
crown	 〈C〉(王位の象徴として国王・王妃などがかぶる)王冠・《the~,[the]C-》『王位』,統治権;君主,王,女王 / 〈C〉(古代・中世で国王などから優者に与えられる)(…の)花冠,頭飾り《+『of』+『名』》;(一般に勝利の栄冠 / 《the~》(…の)絶頂,極致,きわみ《+『of』+『名』》 / 〈C〉(頭・帽子・山・アーチなどの)最も高い部分,頂(いただき) / 〈C〉歯冠;人工歯冠 / 〈C〉《英》クラウン紙幣(英国の旧銀貨);(一般に)王冠をデザインに使った貨幣 / …‘の'頭に王冠をのせる,'を'王位につける / (栄冠・賞を)…‘に'授ける《+『名』+『with』+『名』》 / 〈物が〉…‘の'頂部[てっぺん]をおおっている / 《『crown』+『名』+『名』》(…として)…'を'認める / (…を)…‘に'歯冠をかぶせる《+『名』+『with』+『名』》 
crude	 (原材料が)『天然のままの』,未加工の / (製品・作品などが)仕上がりの悪い,荒造りの / (言葉・態度・考え方などが)粗雑な,不作法な / =crude oil
cruel	 (人・行動が)『残酷な』,無慈悲な / 『悲惨な』,むごい
cruet	 (酢・こしょうなどを入れるガラス製の)薬味(やくみ)入れ / =cruet stand
crumb	 《通例複数形で》(食べるときなどこぼれ落ちる)『パンくず』,ケーキのかけら / (…の)少量,わずか《+『of』+『名』》 / パンの中身(パンの皮の内側にあるふかふかした部分 / …‘に'パン粉をまぶす / 〈パンなど〉'を'ぼろぼろにくずす 
cruse	 (木などを入れる)つぼ 
crush	 …'を'『押しつぶす』,ぺしゃんこにする《+『up』+『名,』+『名』+『up』》 / …'を'『砕く』,粉々にする;…を砕いて(…に)する《+『名』+『into』+『名』》 / (…に)…'を'押しつける《+『名』+『against』+『名』》;(…に)…'を'押し込む《+『名』+『into』+『名』》 / (…から)…'を'押しつぶして出す,しぼり出す《+『名』+『from』+『名』》 / …'を'ぎゅっと抱きしめる / …'を'打ちのめす,打ちひしぐ《+『down』+『名,』+『名』+『down』》 / 『つぶれる』,ぺしゃんこになる;くしゃくしゃになる / 『砕ける』,粉々になる / (…に)押し合って入る,殺到する《+『into』(『through』)+『名』》 / 〈C〉《単数形で》押し合いへし合い,殺到 / 〈C〉《話》《単数形で》大混雑の集会,すしづめの集会 / 〈U〉《英》(押しつぶして出した)果汁 / 〈C〉《話》(…に)のぼせ上がること,(…への)べたぼれ《+『on』+『名』》;のぼせ上がった相手 
crust	 〈C〉〈U〉『パンの皮』,パイの皮;〈C〉堅くなった一切れのパン / 〈C〉〈U〉(物の)堅い表面;(動物の)甲殻(かく);地殻;堅くなった雪面 / 外皮におおわれる《+『over』》 
crypt	 地下室,(特に)教会堂の地下室(小礼拝室・納骨室に用いる) 
cubit	 腕尺(古代の尺度で,ひじから中指の先まどの長さ;45‐56センチ) 
cumin	 カミン[の実](セリ科の植物;実は調味用・薬用) 
curia	 《しばしばD-》ローマ教皇(法王)庁 / 古代ローマの元老院
curio	 こっとう品 
curly	 (髪が)カールした 
curse	 …'を'『のろう』;(…のことで)…'を'『ののしる』,'を'悪口を言う《+『名』+『for』+『名』(do『ing』)》 / (宗教で)〈人〉'を'破門する / (人を)『ののしる』,(人に)悪態をつく《+『at』+『名』》 / 『のろい』 / 『のろいの言葉』(Damn!, Confound it!, Go to hell!など),悪態(Shit!など) / (…への)『たたり』;災いのもと,やっかいなもの《+『on』+『名』》
curst	 =cursed 
curve	 『曲線』 / 『曲がり』,曲がったもの,湾曲部 / (野球で投球の)『カーブ』 / (…の方へ)『曲がる』,湾曲する《+『to』+『名』》 / …'を'曲げる;'を'湾曲させる 
curvy	 曲線の,曲がった / 曲線美の
cushy	 (仕事などが)楽な,容易な,安易な 
cyder	 =cider 
daily	 『毎日の』,日々の / 『毎日』,日々(everyday);日ごとに / 日刊新聞(daily paper) / (また『daily help』)《おもに英話》通いのメイド
dairy	 〈C〉『酪農場』,バター・チーズ・クリーム製造所 / 〈C〉『乳製品販売店』《形容詞的に》『dairy cattle』{名}《集合的に》乳牛『dairy farm』{名}〈C〉酪農場
daisy	 『ヒナギク』 / 《容》すてきな人(物)
dance	 (…に合わせて)『踊る』,舞う,ダンスをする《+『to』+『名』》 / 《副詞[句]を判って》『こおどりする』,跳ね回る / 〈木の葉・光の影などが〉舞う,揺れる / 〈ダンス〉'を'踊る / 《副詞[句]を判って》〈人〉'を'踊らせる / 〈赤ん坊〉'を'上下に揺すってあやす / 《副詞[句]を判って》…'を'踊って(…のように)する(言う) / 『ダンス』,舞踏;舞踏曲;《the~》踊り方 / 『舞踏会』(dancing party) 
datum	 dataの単数形 / 既知の事実
daunt	 …'を'おどす;…'を'ひるませる(discourage) 
davit	 ダビット(船のボートつり柱) 
dealt	 dealの渦去・渦去分詞 
deary	 かわいい人 
death	 〈U〉〈C〉『死』,死亡;死に方,死にざま / 〈U〉死んだ[ような]状体 / 《the~》(…の)絶滅,破滅《+『of』+『名』》 / 《the~》(…の)死の原因,命取り《+『of』+『名』》 / 《通例『D-』》死神(手に鎌(かマ)を持った黒装束の骸骨(がいこつ)で表される) 
debar	 (…から)〈人〉‘を'締め出す,除外する(exclude)《+『名』〈人〉+『from』+『名』》 / (…することを)〈人〉‘に'禁ずる,妨げる(prevent)《+『名』〈人〉+『from』 do『ing』》
debit	 (簿記で)借り方,借り方記入 / (ある金額を)…‘の'借り方に記入する《+『名』+『with』+『名』〈=額〉》 / (相手に)〈金額〉'を'借り方として記入する《+『名』〈金額〉+『against』+『名』》 
debug	 …‘の'欠陥(誤り)を調べて除く;〈部屋など〉‘から'盗聴装置を取り除く 
debut	 社交界へ初めて出ること;初舞台;(いろいろな場への)初登場 / (…として)デビューする
decal	 〈U〉ラフレ画法(絵や図案をガラス・金属などに転写する技術) / 〈C〉その絵・図案がかかれた転写紙
decay	 『腐る』,朽ちる / 〈繁栄・健康などが〉『衰える』,衰退する;〈活力などが〉低下する / 〈他〉 / …'を'『腐らせる』 / 『腐敗』;腐朽 / 『衰微』,衰え / (放射性物質の)自然崩壊 
decor	 (室内などの)装飾 / 舞台装置
decoy	 (狩猟で鳥をおよびきよせる人工の)おとり / (人をおびきよせる)策略,わな / …'を'おとりで誘う,おびきよせる 
decry	 …'を'非難する,けなす 
defog	 〈自動車などの窓〉‘の'曇り(水滴)を取り除く 
degas	 …‘から'ガスを抜く 
deify	 …'を'神に祀る / …'を'神様扱いする
deign	 《『deign to』 do》〈目上の人が〉もったいなくも(…)してくださる / …'を'下さる
deism	 理神論,自然神教 
deist	 理神論者 
deity	 《the D-》(キリスト教の)神 / 〈C〉(キリスト教以外の)神 / 〈U〉神性,神格,神位 
delay	 …'を'『延期する』,延ばす / 〈事故などが〉…'を'『遅らせる』 / 『ぐずぐずする』,『手間取る』 / 『遅れ』,遅延 / 『延期』,猶予 
delft	 デルフト焼き(オランダのDelft産の陶器;白地に青で採色したものが多い) 
delta	 デルタ(ギリシア語アルファベットの第4字Δ,δ;英語D,dに相当) / (河口の)三角州,デルタ / 三角形をしたもの 
demon	 悪霊;悪魔 / 悪魔(鬼)のように残酷な人;(悪などの)権化 / 《話》(超人的な)精力家,名人,鬼才 
demur	 (…に)異議を唱える,反対する《+『at』(『to』+『名』(do『ing』)》 / 異議,反対
denim	 〈U〉デニム(厚地の綿布) / 〈C〉《複数形で》デニム製作業服
depot	 《米》(鉄道の)駅,(バスの)発着所 / (軍隊の)物資集積所 / 置き場,貯蔵所,倉庫 / 《英》連隊本部
depth	 〈U〉〈C〉《通例単数形で》『深さ』;奥行き / 〈U〉(知識・知性などの)『深遠さ』,深さ / 〈U〉(声・音などの調子の)『低さ』;(色の)濃さ / 〈C〉《複数形で》『奥まった場所』,奥地 / 〈C〉深い所,深み / 〈U〉〈C〉《時に複数形で》最中
derby	 〈C〉《米》山高帽(《英》bowler) / 《D-》ダービー競馬(英国ロンドン近郊Epsom Downsで毎年6月第1水曜日に行われる);大競馬,(特に米国の)ケンタッキー競馬 / 〈C〉(一般に)公開競技 / 《米》=bowler
derma	 真皮(true skin),皮膚 
devil	 『悪魔』,悪鬼;《the D-》魔王(Satan) / (悪魔のような)悪人,人非人;(…の)鬼,(悪徳の)権化(ごんげ)《+『of』+『名』》 / 精力家,腕のたっしゃな人 / やつ(fellow),男 / 《俗》《強意語として》 / 《疑問詞の後で》いったいぜんたい / 《強い否定》ぜったい…でない / (また『printer's devil』)印刷屋の使い走り,または見習いの少年 / 《米話》…‘を'いじめる,悩ませる / …‘を'辛く料理する
dhoti	 ドーティ(インドの男子が着用する腰布) 
diary	 『日記』,日記帳,日誌 
dicey	 危険な,いちかばちかの 
dicky	 ぐらぐらする;(物事が)あぶなっかしい 
dicta	 dictumの複数形 
dinar	 ディナール(ユーゴスラビア・イスラム教諸国の貨幣) 
diner	 食事をする人,正餐(せいさん)客 / 《米》=dining car / (食堂車を固定し,あるいはこれに似せた)簡易食堂 
dingo	 ディンゴ(オオカミに似た野犬;オーストラリア産) 
dingy	 黒ずんだ,くすんだ,薄汚い 
dinky	 《米話》取るに足りない / 《英話》こぎれいな,かわいい
dirge	 哀歌(elegy),葬送歌 
dirty	 『汚い』,汚れた,不潔な;泥だらけの,泥んこの / 『不正な』,卑劣な,下劣な / 『下品な』,卑わいな,わいせつな / 《話》(天気が)荒れ模様の(stormy) / (原子兵器が)汚れた,放射性降下物の多い,放射能の多い / …‘を'『汚す』;〈名誉・名声など〉‘を'汚す,傷つける / 汚れる 
disco	 discotheque 
dishy	 (女が)性的魅力のある 
ditch	 (地面に掘った)『溝』,堀,潅漑(かんがい)用水路,排水溝 / …‘に'溝を掘る,溝を巡らせる / 〈車など〉‘を'溝へ落とす;〈列車〉‘を'脱線させる / 〈飛行機〉‘を'水上に不時着させる / 《俗》…‘を'突然に捨てる(見捨てる) / 水上に不時着する
divan	 (壁に沿って置くひじかけや背もたれのない)長いす;寝いす 
diver	 水に飛び込む人 / 『海女』(あま),『潜水夫』;ダイビング競技の選手 / 水に潜る鳥(loon, grebeなど) 
divot	 (ゴルフクラブでそぎ取られた)芝生の小さな塊 
dogie	 (牛の群れの中の)母なし子牛 
dogma	 〈C〉〈U〉(教会などの)『教義』,教理,信条 / 〈C〉独断的な説(主張)
doily	 ドイリー(テーブルの装飾や保護のため花びん・皿などの下に敷く小さな下敷き) 
donut	 =doughnut 
doubt	 『疑い』,疑惑;疑わしさ,疑問 / ‘を'『疑う』,疑問に思う
dough	 練り粉,こね粉,生パン / 《おもに米俗》金銭,ぜに
douse	 …‘を'水中に突っ込む;…‘を'ずぶぬれにする / 《話》〈火・燈火〉‘を'消す
dowel	 合わせくぎ,目くぎ,だぼ 
dower	 寡婦(かふ)産(亡夫の遺産のうち未亡人が受ける部分) / 生まれつきの資質,天賦の才 / =dowry / …‘に'寡婦産を与える / (才能・資質などを)…‘に'与える,賦与する(endow) 
downy	 綿毛(うぶ毛)のような;綿毛でおおわれた 
dowry	 (花嫁の)持参金 
dowse	 =douse 
doyen	 (団体などの)古参者,長老,大御所 
dozen	 『ダース』,12個の組(《略》『doz.,dz.』) 
drabs	 =dribs 
drain	 (液体を)…‘から'『排出する』《+『名』+『of』+『名』》;(…から)〈液体〉‘を'『排出する』《+『名』+『from』+『名』》 / …‘を'消耗させる,枯渇させる;(…を)〈人〉‘から'消耗させる《+『名』+『of』+『名』》 / 〈酒など〉‘を'飲み干す,空にする / 〈土地〉‘を'干上がらせる / 〈土地などが〉水はけがよい;(液体を)排出する《+『of』+『名』》 / 〈水・液体などが〉徐々に流れ去る / 〈C〉『排水設備』,排水路 / 〈C〉(…を)消耗(枯渇)させるもの《+『on』+『名』》 / 〈U〉《時にa~》(富・力などの)消耗,枯渇 
drake	 雄ガモ 
drank	 drinkの過去,《時に米》過去分詞 
drape	 …‘を'掛け布でおおう;(垂れ布などで)…‘を'飾る《+『名』+『with』(『in』)+『名』》 / …‘を'ぞんざいに置く,だらりと下げる / 〈布・服など〉‘に'ゆるい優美なひだをつける / 〈掛け布などが〉優美なひだになって垂れ下がる / 〈C〉《通例複数形で》掛け布,垂れ布;《米》特に左右に開閉する1対の長いカーテン / 〈U〉《またa~》(布などの)たれぐあい
drawl	 (特に母音を引き伸ばして)ゆっくり話す / …‘を'ゆっくり話す / (母音を引き伸ばした)ゆっくりした話し振り 
drawn	 drawの過去分詞 / 緊張した,こわばった / (鳥などの)はらわたを抜いた / (剣などが)さやから抜かれた,抜き身の / (勝負が)引き分けの 
dream	 『夢』 / 『白昼夢』,幻想(daydream) / 抱負,強い希望,夢 / 《話》夢のように美しいもの,魅力のあるもの / 『夢を見る』 / (…を)『夢想する』,思い描く《+『of』(『about』)+『名』(do『ing』)》 / …‘を'『夢に見る』,《a+形容詞+dreamを目的語にして》〈…の夢〉‘を'見る / 《『dream』+『that節』》…‘と'『思う』,想像する / 〈時〉‘を'うかうかと過ごす《+『away』+『名』》 
dregs	 (飲み物の)かす,おり / 最もつまらないもの
dribs	 少量,ほんの少し 
drift	 〈U〉『漂流』,流されること / 〈U〉(海流・風などの)流れ,流れの方向(速度) / 〈C〉(雪・砂などの)吹きだまり,漂流物《+『of』+『名』》 / 〈U〉〈C〉大勢,風潮,傾向 / 〈U〉《時にa~》主意,主旨 / (水・風に)『流される』,漂う,漂流する / あてもなくさまよう / 〈雪・砂などが〉吹き積もる,吹きだまりになる / 〈砂・雪など〉‘を'吹き寄せる;〈場所〉‘を'吹きだまりにする 
drily	 =dryly 
drink	 〈飲み物〉‘を'『飲む』 / 〈植物・地面・物が〉〈水分など〉‘を'吸収する;〈人が〉〈空気〉‘を'深く吸う / 〈カップ・グラスなど容器の中身〉‘を'飲む,飲み干す / 《副詞[句]を伴って》〈金・時間など〉‘を'酒で飲みつぶす / (…のために)…‘に'祝杯を上げる,…‘を'祈って乾杯する《+『名』+『to』+『名』》 / (飲み物を)『飲む』 / (習慣で,また過度に)酒を飲む / (…のために祈って)乾杯する《+『to』+『名』》 / 〈U〉〈C〉『飲み物』,飲料 / 〈U〉『酒』;飲酒 / 〈C〉(飲み物の)ひと飲み,1杯 
drive	 (…から…へ)〈動物・敵など〉‘を'『追い立てる』,追い払う,追い出す《+『名』+『away』(『out』)『from』+『名』+『to』+『名』》 / (…から)…‘を'押しやる,押し流す《+『名』+『off』(『out of』)+『名』》 / 〈人〉‘を'駆り立てる(force) / 〈車・馬車〉‘を'『運転する』,操縦する;〈馬〉‘を'御する / 《副詞[句]を伴って》(ある場所へ)〈人〉‘を'車(馬車)で運ぶ(送る) / (…に)〈くい・くぎ・ねじなど〉‘を'打ち込む,差し込む《+『名』+『in』(『into, through』)+『名』》 / 〈人〉‘を'酷使する / 〈商売・取引など〉‘を'活発に行う,強力に進める / (…に)〈トンネルなど〉‘を'掘る,通す《+『名』+『through』+『名』》 / 〈動力が〉〈機械など〉‘を'運転する,動かす / 『車を運転する』 / 《副詞[句]を伴って》車で行く,ドライブする / 〈車・船などが〉(…に)突進する;〈雨・風が〉(…に)激しく吹きつける《+『against』(『into』)+『名』》 / 〈C〉(馬車・自動車などに)乗って行くこと,遠乗り,『ドライブ』 / 〈U〉(馬車・自動車で行く)道のり,行程 / 〈C〉(特に邸内・公園内の)車道 / 〈U〉〈C〉(自動車などの)駆動装置 / 〈C〉(目的達成のための)組織的活動,運動 / 〈U〉元気,迫力,精力 / 〈U〉突進;(軍隊の)猛攻撃 / 〈C〉(心理的な)動因,本能的要求 / 〈U〉〈C〉(ゴルフ・テニスなどの)強打 / 〈C〉(家畜などを)追い立てること 
drone	 (特にミツバチの)雄バチ / (他人の労働で生活する)怠け者,ごくつぶし
drove	 driveの過去形 
drown	 …‘を'『溺死』(できし)『させる』 / (…で)…‘を'水浸しにする,ずぶぬれにさせる《+『名』+『in』(『with』)+『名』》 / 〈大きな音が〉〈ほかの音〉‘を'かき消す《+『out』+『名,』+『名』+『out』》 / (仕事・研究などに)〈自分〉‘を'熱中させる,(酒などで)〈憂いなど〉‘を'晴らす,紛らす《+『名』+『in』+『名』》 / 『溺死』(できし)『する』 
drunk	 drinkの過去分詞 / 酒に酔って,酔っぱらって / (感動・喜びなどに)酔いしれて,夢中になって《+『with』+『名』》 / 酔っぱらい
drupe	 核果,石果(さくらんぼ・梅・桃など) 
ducal	 公爵(duke)の,公爵らしい,公爵領の 
ducat	 ダカット金貨(昔欧州で使用された) 
duchy	 公国,公爵領(dukeまたはduchessの領地) 
ducky	 すてきな,すばらしい / あなた
dukes	 握りこぶし,げんこつ 
dumps	憂鬱
dumpy	 (人が)ずんぐりした 
dunce	 のろまな人,ばか者 
duple	 (音楽が)2拍子の,偶数拍子の 
durst	 dareの過去 
dusky	 (色が)黒みがかった / 薄暗い
dusty	 『ほこりっぽい』,ほこりだらけの / ほこりのような色の,つやのない / ほこりのような,粉末状の 
duvet	 羽根ぶとん 
dwarf	 (童話の)『こびと』,一寸法師 / (人間の)こびと / 普通よりずっと小さい動物(植物) / (対照的に)…‘を'小さく見せる / 〈植物など〉‘の'自然な成長を妨げる / (並みはずれて)小さい[種類の]
dwelt	 dwellの過去・過去分詞 
dying	 dieの現在分詞 / 死にかかっている,ひん死の / 消えかかっている,滅びかけている / 臨終の
early	 (時間・時期が)『早い』,『初期の』 / 昔の / (普通より,予定より)早い / 近い将来の / (時間・時期的に)『早く』 / (予定・ふだんより)早く
earth	 《the~,時に[the]E-》『地球』 / 〈U〉(天,空に対して)『地』,地面 / 〈U〉『土』(soil) / 《the~》世界;全世界の人々 / 〈C〉土(ど)類(金属酸化物) / 〈C〉《英》アース,接地[線] / 〈C〉《おもに英》(キツネなどの)穴 / 〈植物〉‘に'土をかぶせる《+『op』+『名』》 / 《英》…‘に'アース線をつなぐ;…‘を'アースする(《米》ground) 
ebony	 コクタン(ピアノの黒けんや高級家具用の黒い硬質木材) / コクタンの色 / コクタン色の 
eclat	 華々しい成功;拍手かっさい 
edict	 勅令,布告 
edify	 …‘を'教化する,啓発する 
eight	 〈C〉(数の)8;8の記号(18,VIIなど) / 〈U〉8時,8分;8歳 / 〈U〉《複数扱い》8人,8個 / 〈C〉八つ(8人,8個)一組のもの;8人のボート選手 / 〈C〉(カードの)8の札;〈U〉(スケートの)8字形[滑走](the figure of eight) / 8の;8人の / 8個の;《補語にのみ用いて》8歳で 
eland	 オオカモシカ(アフリカ産のカモシカ) 
elbow	 『ひじ』 / ひじ形(L字形)のもの;ひじ形の屈曲;(管の)ひじ形継ぎ手;(いすの)ひじ掛け / …‘を'『ひじで押す』(『突く』);(…から)…‘を'ひじで押し出す《+『名』+『out of』+『名』》 
elfin	 小妖精の / 小妖精のような
empty	 『からの』,中に何もない(だれも居ない) / 『空虚な』,なんの意味もない / 《話》腹ぺこの / 〈容器など〉‘を'『空にする』 / (容器などから)〈中身〉‘を'出して空にする《+『名』+『out of』+『名』》;(…に)〈中身〉‘を'全部出す《+『名』+『into』(『onto』)+『名』》 / 『空になる』;(…に)全部出て空になる《+『into』+『名』》 / 空き箱,空きびん 
enact	 〈法律〉‘を'制定する;…‘を'法令(条令)化する / (弓など)‘を'演じる;…‘の'役を演じる
endow	 〈学校など〉‘に'『寄付する』,基金を贈る / 《しばしば受動態で》(優れた能力・才能などを)〈人〉‘に'『与える』,授ける《+『名』+『with』+『名』》
enjoy	 ‘を'『楽しむ』 / ‘に'『恵まれている』,‘を'享受する
entry	 〈C〉〈U〉(場所などに)『入ること』,『入場』,登場;(団体・競技などへの)参加,加入(entrance)《+『into』+『名』》 / 〈C〉《おもに米》(…への)入り口(entrance),玄関《+『of』(『to』)+『名』》 / 〈C〉(帳簿・日記・表などの)『記載事項』,項目;(…の)『記入』《+『of』+『名』》 / 〈C〉(競技・コンテストなどの)『参加者』,参加作品《+『for』(『in』)+『名』》 / 〈C〉(辞書などの)見出し語 
envoy	 使者 / 外交官,外交使節 / 特命全権公使;公使 
epoch	 『画期的な時代』,時期 / (歴史上の)新時代,新紀元 / 世(せい)(紀(period)の次に小さい単位) 
epoxy	 エポキシ[樹脂](接着剤・塗料などに用いる) 
equal	 『等しい』,同じ / 『平等の』 / 互角の;均等の / (任務・作業などに)耐える力がある,(…する)力量がある《+『to』+名(do『ing』)》 / (…と)『同等の人(物)』《+『of』+『名』》 / …‘に'等しい,匹敵する;(…の点で)…‘に'匹敵する《+『名』+『in(as)』+『名』》
equip	 (ある目的のために必要な装備などで)〈人〉‘に'『したくさせる』,〈船・軍隊など〉‘に'『装備する』《+『名』+『with』+『名』》,(…に備えて)…‘に'したくさせる,‘を'装備する《+『名』+『for』+『名』》 / (必要な知識・能力などを)〈人〉‘に'身につけさせる:《『equip』+『名』〈人〉+『with』+『名』+『for』+『名』…に備えて…を人に身につけさせる》
ergot	 麦角(ばっかく)病(麦角菌によるライ麦など穀物の病気) / 麦角(止血剤・子宮収縮剤用)
eruct	 〈おくび・げっぷ〉‘を'出す / 〈火山などが〉〈煙など〉‘を'噴出する / おくびを出す;吐き出す 
erupt	 〈火山灰・間欠泉などが〉噴出する,〈火山が〉噴火する / 〈争いなどが〉突然起こる;〈感情が〉爆発する / 〈溶岩・熱湯など〉‘を'噴出させる / 〈怒りなど〉‘を'爆発させる
ethic	 倫理,道徳律 / =ethical
ethos	 (個人・社会の信念・習慣・風習を形成する)気風,心情 
ethyl	 エチル / エチルの
evict	 (法律の力で)(家・土地などから)〈人〉‘を'立ち退かせる《+『名』+『from』+『名』》 
exact	 《名紙の前にのみ用いて》(数量など)『正確な』,きっかりの;(物事が)そのままの,そっくりの / (人が)『厳密な』;(機械など)精密な / 〈事柄が〉…‘を'要求する / (人に)〈支払・服従など〉‘を'強要する,強いる《+『名』+『from』+『名』〈人〉》
exalt	 (高い地位に)〈人〉‘を'『昇進させる』,上げる《+『名』〈人〉+『to』+『名』》 / 〈人など〉‘を'ほめる,賞賛する
exist	 『存在する』,実在する / 『生在する』,生きている / 生じる,見られる,起こる 
expwy	 expressway 
extra	 『余分の』(additional);『臨時の』,特別の,割増しの / 『付属するもの』(別売りの不属品など) / (新聞の)告外《+『to』+『名』》 / 割増し料金 / (映画の)エキストラ / 余分に / 異常に,特別に 
exult	 大喜びする 
exurb	 準郊外(郊外のさらに外部にあり,富裕階級が住む地域) 
fable	 〈C〉(動物などを擬人化し教訓を含んだ)『寓話』 / 〈C〉伝説;神話 / 〈U〉《集合的に》伝説(legends);神話(myths) / 〈C〉作り話;うそ
faced	 (…に)面した,直面した《+『with』+『名』》 / 上張りをした,縁飾りをした
facet	 (宝石・結晶などのなめらかな)面,切り子面 / (物事の)面(aspect)
faint	 (音・色・考えなどが)『かすかな』,ぼんやりした / (努力・行動などが)『弱々しい』,熱のない;気の弱い,勇気のない / 《補語にのみ用いて》(で)『気が遠くなって』目が回りそうで《+『with』(『from』)+『名』》 / (…で)『気が遠くなる』,気絶する《+『with』(『from』)+『名』》 / 気絶,失神 
fairy	 『妖精』(ようせい) / 妖精の / 妖精のような,優美な 
faith	 〈U〉『信頼』,信用;確信,信念 / 〈U〉(…への)『信仰』,(…に対する)信心(belief)《+『in』+『名』》 / 〈C〉教義,信条(doctrine) / 〈U〉信義,誠実(sincerity) / 〈U〉誓約,約束 
faker	 偽造者,ねつ造する人 / 詐欺師,ペテン師
fakir	 (イスラム教・バラモン教などの)行者,たくはつ僧 
false	 『正しくない』,誤った / 『本物でない』,作りものの(artificial) / 人を誤らせるような,人を惑わせる(deceptive) / 信頼を裏切る,不実な / うそを言う,正直でない / だまして
famed	 名高い;(…で)有名な《+『for』+『名』》 
fancy	 〈U〉(取りとめのない)『空想』,想像 / 空想したもの,根拠のない考え(意見) / 〈C〉(…に対する)『好み』(liking)《+『for』+『名』(do『ing』)》 / 『装飾的な』,意匠をこらした / 空想に基づく,気まぐれな / 《名詞の前にのみ用いて》(商品が)高級な,特選の,極上の / 《名詞の前にのみ用いて》《話》(値段が)法外な / 高度の技術の(を要する),こみ入った / 《名詞の前にのみ用いて》(動植物が)珍種の / …‘を'『空想する』,想像する(《米》imagine) / …‘を'『好む』 / 《『fancy doing』》…したい気がする / (なんとなく)…‘と'『思う』 
farce	 笑劇,どたばた喜劇,道化芝居 / 茶番的行為,ばかげた事件
fated	 宿命の,破滅を運命づけられた,運のつきた 
fault	 〈C〉『欠点』,短所(defect) / 〈C〉『誤り』,落ち度 / 〈U〉(過失の)『責任』,罪 / 〈C〉断層(地層の食い違い) / 〈C〉フォールト(テニスなどでサーブの失敗) / …‘の'あら捜しをする / あやまちを犯す / 断層を生じる
feast	 (宗教的な)『祝祭』,祭礼;祭日,祝日 / 祝宴,宴会(banquet);ごちそう / (…の)目や耳を楽しませるもの,(…にとっての)楽しみ《+『for』(『to』)+『名』》 / (…で)…‘に'『ごちそうする』,‘を'もてなす《+名+on(upon)+名》 / 《文》(…で)〈目や耳〉‘を'喜ばせる,楽しませる《+『名』+『on』(『upon』)+『名』》 / 宴を張って〈時〉‘を'過ごす《+『名』+『away』》 / (…の)祝宴に列する,(…を)ごちそうになる《+『on』(『upon』)+『名』》 
fecal	 大便の 
feign	 …‘の'『ふりをする』,‘を'装う(pretend) / 〈口実など〉‘を'作り上げる,でっち上げる(invent) / 見せかける,偽る 
feint	 (ボクシング・フェンシングなどで)攻撃のふりをすること;(戦闘で敵をあざむくための)陽動作戦 / 見せかけ
felon	 重罪犯人 
femur	 大腿骨(だいたいこつ)(thighbone) 
feral	 (動植物が)野生の / 野生に返った
ferny	 シダの,シダの茂った 
fetch	 (行って)〈物〉‘を'『取って来る』;〈人〉‘を'連れて来る / 〈返事・笑い・涙など〉‘を'引き出す;〈観客など〉‘を'引きつける / 《話》〈商品が〉〈ある値〉‘で'売れる / 〈ため測・うめき声など〉‘を'漏らす,出す / (品物を)行って用る;〈猟犬が〉獲物を取って来る 
fetid	 (特に水が)悪臭を放つ 
fibre	 =fiber 
fiche	 =microfiche 
fichu	 婦人用三角ストール 
field	 〈C〉『野原』,[牧]草地;田;畑;《the fields》田野,田畑 / 〈C〉(雪・氷などの)原,広がり / 〈C〉(鉱物などの)産出地,埋蔵地 / 〈C〉『戦場』(battlefield);戦闘(battle) / 〈C〉(スポーツの)『競技場』;(陸上のトラックに対して)フィールド / 〈C〉(ある用途の)場,地面 / 〈C〉(研究・活動などの)『分野』,領域 / 《the~》現地 / 〈C〉(電気・磁気などの)場;(レンズの)視界 / 〈C〉(絵・旗などの)地,下地 / 《the~》《集合的に》(キツネ狩り・競技の)参加者;(競馬の)出走馬;(野球の)守備選手 / (野球・クリケットで)〈打球〉‘を'さばく / 〈選手〉‘を'出場させる,守備につける / (野球・クリケットで)野手をつとめる
fiend	 悪魔(devil),悪鬼 / 邪悪(残忍)な人 / 《話》(趣味などに)凝っている人;)麻薬などの)常習者 
fiery	 『火の』,火のついた,燃えている / (火のように)『ひどく熱い』,『真赤な』,輝く / 『熱烈な』,激しい / (気性などが)激しやすい,荒々しい
fight	 〈両者・数人が〉『戦う』,格闘する,殴り合い(取っ組み合い)のけんかをする;激しく口論する / …‘と'『戦う』 / 〈戦い〉‘を'交える,〈決闘など〉‘を'戦う / …‘を'制圧(克服)しようとする / 〈犬など〉‘を'戦わせる / 〈軍艦・軍隊など〉‘を'指揮する,操縦する / 〈C〉(…との)『戦い』,戦闘;格闘《+『against』(『with』)+『名』》 / 〈C〉(…との)奮闘,闘争(struggle)《+『for』(『with』,『against』)+『名』》 / (また『fighting spirit』)〈U〉『闘志』,ファイト / 〈C〉(…についての)論争,口論《+『over』+『名』》 / 〈C〉(特にボクシングの)試合,勝負 
filar	 糸の,糸飾の 
filch	 〈あまり価値のない物〉‘を'盗む,くすねる 
filet	 =fillet2 
filmy	 (カーテン・氷など)非常に薄い,薄い膜のような / (湯気などで)うっすらとおおわれた
filth	 汚物,不潔な物 / 不潔な状態;(道徳的な)腐敗,堕落 / 卑わい;卑わいな言葉 
final	 《名詞の前にのみ用いて》『最終の』,最後の / 『最終的な』,決定的な(decisive);究極の(ultimate) / 《しばしば複数形で》(競技などの)『決勝戦』 / 《米》学期末試験;《英》《複数形で》(大学などの)最終試験 / 《the ~》《話》(新聞のその日の)最終版 
finch	 スズメ科の小鳥 
first	 (順序・時間的に)『第1の』,1番目の;最初の / (階級・等級・重要度などが)『1番の』,第一級の,首席の,最も重要な / 『最初に』,まっ先に;1番目に,第1位に;初めて / (…するくらいなら)むしろ,いっそ(…のほうがいい)(rather, sooner) / 《通例the~》『最初のもの』;(月の)第1日;(時代の)第1年 / 《通例the~》初め,始まり / 〈U〉ファーストギヤ,低速ギヤ / 〈C〉《英》(競技などの)第1位,1等(試験の)第一級 / 《複数形で》最高級品,一級品 / 〈U〉=first base
firth	 (陸地に細長く込りんだ)河口,入り江 
fishy	 うさんくさい・魚のような,魚くさい / (料理が)魚から成る / (湖・川など)魚のたくさんいる / 《話》(話などが)ありそうにない / (目が)どんよりとした,無表情な 
fiver	 5ドル紙幣;《英話》5ポンド紙幣 
fives	 ファイブズ(三方を囲んだ壁に手またはバットでボールを打つゲーム) 
fixed	 『固定した』,据え付けの / (視線などが)動かない / 確定した,変動しない / 八百長の
fixer	 八百長を仕組む人 / 裏取引をする人 / (写真の)定着液 
fjord	 =fiord 
flack	 =press agent 
flair	 (…に対する)眼識,能力,才能《+『for』+『名』(do『ing』)》 
flake	 (…の)『薄片』,(はげ落たち)一片;(雪・雲・羽毛などの)一片,ひとひら《+『of』+『名』》 / 〈雪などが〉ちらちら降る / (…から)…‘を'薄くはがす《+『名』+『from』(『off』+『名』) 
flaky	 薄片[状]の;薄片から成る / 薄くはがれる
flame	 〈U〉〈C〉《しばしば複数形で》『炎』 / 〈U〉炎のような輝き;炎色 / 〈C〉《おもに文》(…の)(燃えるような)情熱,激情《+『of』+『名』》 / 『炎をあげて燃える』,燃えさかる《+『up』》 / (炎のように)照え映える《+『up』》 / 〈怒り・情熱などが〉燃え上がる;〈人が〉かっと怒り出す《+『out』(『up, forth』)》
flank	 (人・動物の)横腹;わき腹の[筋]肉 / (建物・山・道路などの)わき,横側,側面 / (軍隊の編隊・配置,要塞の)右翼(または左翼) / …‘の'側面に置く(並べる)
flare	 (風などで)〈炎が〉ゆらゆら燃える / 〈怒りなどが〉急に燃え上がえる / (らっぱの口のように)外に向かって開く;〈スカートが〉フレアになっている / 〈U〉ぱっと燃え上がる炎(光) / 〈C〉照明装置;照明弾 / 〈C〉《単数形で》(感情などの)ほとばしり.爆発《+『of』+『名』》 / 〈U〉(らっぱの口のような)(…の)末広がり《+『of』+『名』》 
flash	 (花・炎などの)『ひらめき』,ぴかっと(ぱっと,ちらっと)光ること;閃光(せんこう)《+『of』+『名』》 / (機知などの)『ひらめき』;(喜びなどが)急にわいてくること《+『of』+『名』》 / (写真の)フラッシュ / 瞬間 / ニュース速報,特報 / 『ぱっと光る』,(反射して)きらめく / 〈目などが〉きらりと(ぎらっと)光る / (心に)〈言葉・考えなどが〉『ひらめく』《+『through』(『into, across』)+『名』》 / 《副詞[句]を伴って》〈人・車などが〉さっと通り過ぎる / …‘を'ぱっと照らす;〈火・光〉‘を'ぱっと発する / …‘を'ちらり(ぴかり,ぎらり)とさせる / (…に)〈サイン・視線など〉‘を'すばやく送る,さっと送る《+『名』+『at』+『名』》 / (電信で)…‘を'急送する,速報する / 急で短い,瞬間的な / 《英話》(現代ふうで)気のきいた 
flask	 (実験用の)フラスコ / (一般に)びん;(特に携帯用の)薄型の小びん
fleck	 斑点(はんてん),そばかす(freckle) / (…の)細片,薄片(flake);微量《+『of』+『名』》 / (…で)…‘に'斑点をつける,‘を'まだらにする《+『名』+『with』+『名』》 
flesh	 (人間・動物の)『肉』 / (魚,時には鳥を除く)食肉(meat) / 肉付き,太りぐあい / (くだもの)果肉;(野菜の)葉肉 / 《the~》(精神・魂に対して)『肉体』,身体 / 《the~》肉欲 / 肉色(ピンクがかった肌色) 
flick	 軽い一打ち;(指先での)一はじき;(手首などの)す早い一振り / ピシッ(パチッ)という音 / 《the flicks》《俗》映画 / (むちなどで)…‘を'ピシッ(パチッ)と打つ《+『名』+『with』+『名』》 / …‘を'はじいて動かす / …‘を'ぱっと(さっと)払いのける《+『away』(『off』)+『名,』+『名』+『away』(『off』)》;(…から)…‘を'ぱっと払う《+『名』+『off』(『from』)+『名』》
flied	 fly(野球で「フライを打つ」の意味のとき)の過去・過去分詞 
fling	 《副詞[句]を伴って》…‘を'『投げる』,ほうり出す / 《副詞[句]を伴って》〈頭・腕・身体など〉‘を'投げかける,投げるように動かす / (ほうり出すように)急に(荒々しく)動く / (…を)『振って投げること』;振り動かすこと《+『of』+『名』》 / (定期間の)したいほうだい,かって気まま / 身ぶりの活発なスコットランドのダンス
flint	 火打ち石;ライターの石 
flirt	 〈男女が〉ふざける;(…と)いちゃつく《+『with』+『名』》 / (考え・危険などを)もてあそぶ,(…に)おもしろ半分に手を出す《+『with』+『名』(do『ing』)》 / 浮気男(女) 
float	 (液体・気体に)『浮く』,浮かぶ / 《副詞[句]を伴って》漂うように移動する;ふわふわと動く / (眼前・心に)浮かぶ;〈うわさなどが〉広まる / 〈為替相場が〉変動する / 《副詞[句]を伴って》(水中・空中に)…‘を'『浮かせる』,漂わせる / 〈会社・計画など〉‘を'起こす;〈債券〉‘を'発行する / 〈為替〉‘を'変動相場制にする / 浮くもの(釣りのうき,いかだ,浮標,浮き袋,救命具など) / (パレードなどの)山車(だし),台車 / フロート(アイスクリームを浮かせた軽い飲みもの)
flock	 〈C〉(同一種の動物,特に羊,ヤギ,鳥などの)『群れ』《+『of』+『名』》 / 〈C〉(…の)『群衆』,大勢(の…)《+『of』+『名』》 / 《集合的に》全キリスト教徒;キリスト教会;(牧師に対してその)教会員,会衆 / 『群がる』;群れをなして来る(行く)
flora	 (ある地方・時代の)植物群(相),全植物 
flour	 『小表粉』,メリケン粉 / (一般に穀類の)粉末,粉 / …‘に'粉をまぶす;〈穀物〉‘を'粉にひく 
flout	 〈人の忠告・伝統・法律など〉‘を'軽んじる,ばかにする 
flown	 flyの過去分詞 
fluid	 『流体』,流動体 / 『流動性の』,流動する / 流体の,流動体から成る / 変わりやすい,固定していない,浮動する
fluke	 いかりづめ,いかりかぎ(いかり(anchor)の腕の両端にある三角形の部分で水底に引っ掛けるためのもの) / (もり・やり・矢などの先端の)かかり,かぎ / 鯨の尾の二つに分かれた三角形の一方 
flume	 (水の流れる)深くて狭い谷,狭谷 / (木材運搬・水力供給などのための)人工水路,とい式水露
flung	 flingの過去・過去分詞 
flunk	 〈試験など〉‘を'しくじる,‘に'落第する(fail) / 〈先生が〉〈学生など〉‘に'落第点をつける / (試験などに)落第する《+『in』+『名』》 
flush	 〈顔が〉『赤らむ』,〈人が〉赤面する《+『up』》 / 〈水などが〉『どっと流れる』;水をどっと流す《+『out』》 / 《しばしば受動態で》〈顔など〉‘を'『赤くさせる』,〈人〉‘を'赤面させる / …‘に'水をどっと流す(流して洗う) / 《受動態で》(成功などで)〈人〉‘を'興奮させる,得意がらせる《+『with』+『名』》 / 〈C〉(顔などの)『紅潮』,赤らみ / 〈C〉(…の)興奮,得意《+『of』+『名』》 / 〈U〉《the~》(…の)はつらつさ,活気《+『of』+『名』》 / 〈C〉《単数形で》(水などが)激しく流れること,(…の)殺到《+『of』+『名』》 / 〈C〉洗浄,水洗い;(便所の)水洗
flute	 『フルート』,横笛 / (柱の)浅くて丸みを帯びた縦溝 / フルーとを吹く / フルートのような音を出す / …‘を'フルートの音のような声で話す(歌う) / (柱・パイの皮など)‘に'縦溝をつける(彫る)
flyer	 =flier 
foamy	 泡の;泡のような;泡だらけの 
focal	 焦点の 
focus	 『焦点』 / 焦点距離(focal length) / 焦点整合,ピント / (活動・興味・重要性などの)焦点,中心 / (楕円・放物線・双曲線などの)焦点 / 震源[地] / (…に)〈レンズなど〉‘の'『焦点を合わせる』《+『名』+『on』+『名』》 / (…に)〈注意など〉‘を'集中する《+『名』+『on』+『名』(do『ing』)》 / (…に)〈レンズなどの〉焦点が合う;〈注意などが〉集まる《+『on』+『名』》 
fogey	 =forgy 
foist	 (…に)〈偽物など〉‘を'押しつける,つかませる《+『名』+『on(upon)』+『名』》 
foray	 (…への)不意打ち,急襲《+『on』+『名』》 / (他の分野への)手出し,冒険《+『into』+『名』》 / (特に略奪のために)(摘の領土などを)侵略する《+『into』+『名』》 
force	 〈U〉(物理的な)『力』,勢い;体力 / 〈U〉『暴力』,腕ずく / 〈C〉《集合的に》(共通の目的・活動のための)集団,隊 / 〈C〉《しばしば複数形で》『軍隊』,部隊 / 〈C〉(社会的)勢力;有力な人物 / 〈U〉(精神あるいは知性の)力 / 〈U〉『影響力』,効果 / 〈U〉(言葉の)意味,真意 / 〈人〉‘に'『強いる』,無理を言う / (…から)…‘を'力ずくで手に入れる《+『名』+『from』(『out of』)+『名』》 / …‘を'むりに押し出す / (容器などに)…‘を'むりに押し込む《+『名』+『into』+『名』》 / (人に)…‘を'『押しつける』《+『名』+『on』(『upon』)+『名』〈人〉》 / 〈植物〉‘を'促成栽培する
forge	 (かじ場の)炉 / かじ屋の仕事場;鉄工場 / 〈金属〉‘を'鍛(きた)える;(…から)〈馬ていなど〉‘を'鍛えて作る《forge+名+from)out of)+名》 / 〈計画など〉‘を'作り上げる / 〈文書など〉‘を'偽造する 
forte	 得意なもの(こと),おはこ 
forth	 (空間的に)『前へ』,先へ;外へ,表へ / (時間的に)『先』;今後,以後
forty	 〈C〉(数の)『40』;40の記号(40,XLなど) / 〈U〉40分;40歳 / 〈U〉《複数扱い》40人,40個 / 《the forties》(世紀の)40年代;《one's forties》(年齢の)40代 / 40の,40人の,40個の / 《補語にのみ用いて》40歳の(で)
forum	 《the Fo・rum》(古代ローマの)大広場,市場(商業取引や裁判・政治などの集会所として用いられた) / 〈C〉(公開討論・批判などの)広場,フォーラム / 〈C〉討論会 
found	 findの過去・過去分詞 
fount	 《詩》泉(fountain) / (知識・霊感などの)源泉《+『of』+『名』》
foxed	 (古本などが)黄ばんだ,黄渇色のしみのついた 
foyer	 劇場・ホテルなどの)休憩室,ロビー(lobby) / 《米》玄関の広間
frail	 『もろい』;か弱い;はかない / 意志が弱い,誘惑に負けやすい
frame	 〈C〉(建造物・機械などの)『骨組み』《+『of』+『名』》 / 〈C〉(戸・窓などの)『枠』;額縁《+『of』+『名』》《複数形で》めがねの枠 / 〈C〉『体格』 / 〈C〉(…の)構造,体制《+『of』+『名』》 / 〈C〉(簡略な)温室,温床 / 〈C〉(ボーリングで)フレーム(10回で1ゲームを構成するその各回);各回の得点を記入する枠 / 〈C〉(映画のフイルムの)一こま / 《修飾語を伴って》《a~》気持ち,気分 / (組み合わせて)…‘を'『形作る』,組み立てる;(ある目的などに合うように)〈人・物〉‘を'作り上げる / 〈考え・構想など〉‘を'心に抱く / 〈絵など〉‘を'粋に入れる,縁どる / 〈言葉など〉‘を'言う / 《話》〈人〉‘に'ぬれぎぬを着せる 
franc	 フラン(フランス・ベルギー・スイスなどの貨幣単位) 
frank	 『率直な』,隠しだてをしない 
fraud	 〈T〉詐欺,ごまかし, / 〈C〉詐欺行為,不正手段, / 〈C〉にせ物,まやかし物 / 〈C〉ぺてん師,くわせ者
freak	 気まぐれ,移り気 / 奇形,変態 / 《話》奇人,変人;熱狂的ファン / 奇形の,異常な
fresh	 『新鮮な』,生きのいい / 『はつらつとした』,若々しい / (印象・色などが)『鮮やかな』,薄れていない;(色が)塗りたての / これまでになかった,初めての;新規の新たな / 新米の,未熟な / (空気が)さわやかな,涼しい / (風が)やや強い / (水が)塩けのない;飲用できる / 《米話》(特に異性に対して)なれなれしい,ずうずうしい《+『with』(『to』)+『名』》 / 新たに,新しく
fried	 fryの過去・過去分詞 / 油で焼いた(揚げた)
frisk	 はね回る,(じゃれて)飛び回る / (特に,隠し持つ武器の有無を知るために)〈人〉‘を'衣服の上から触って調べる / 飛びはね,はね回り 
frock	 《まれ》(婦人・子供の上下続いた)服 / (聖職者の着る)法衣
frond	 (シダ・シュロなどの)葉 / (海草・地衣類などの)葉状体
front	 《the~》(物の)『前面』,表;(玄関を含む建物の)正面;(…の)最前部《+『of』+『名』》 / 《the~》(本などの)最初の部分 / 〈U〉《しばしばa~》(物事に対する)態度 / 〈C〉(共通目的のための)共同戦線,運動,提携 / 〈C〉(街路・川・湖に面した)土地;《英》(海岸の)遊歩道 / 〈C〉戦線 / 《話》〈C〉世間の目をそらすための人(物);(…の)隠れみの《+『for』+『名』》 / 〈C〉(気象上の)前線 / 〈C〉前部に位置する(ある)もの(ワイシャツの胸当て,前頭部など) / 『正面の』,前の;表の / (発音で)前舌音の / 〈場所が〉…‘に'面する / (…を)…‘の'正面(前面)につける《+『名』+『with』+『名』》 / 《古》〈敵・困難・危険など〉‘に'立ち向かう,直面する / (…に)面する《+『on』(『to,toward,upon』)+『名』》 
frost	 〈U〉〈C〉『霜』;霜が降りること / 〈U〉例の降りる寒さ;《英》氷点以下の温度 / 〈C〉《話》《軽べつして》《催しなどの》失敗,しくじり,(劇なじの)不入り,失敗作 / …‘を'霜で覆う / …‘を'霜枯れにさせる,(霜のように冷たい雨などで)凍らせる / (糖衣・砂糖などを)〈ケーキなど〉‘に'まぶす,かぶせる《+『名』+『with』+『名』》 / 〈ガラス〉‘を'つや消しにする / 〈物が〉霜で覆われる《+『over』》 / 《itを主語にして》霜を結ぶ,凍る 
froth	 (ビール・サイダーなどの)泡,あぶく(bubble) / 《軽べつして》むだ話;たわいない考え / …‘を'泡立させる / 泡を出す
frown	 (怒り・物思い・不賛成などによる)『しかめづら』,渋い顔 / 不賛成の表明 / (怒り・物思い・不賛成などで)(…に)『まゆをひそめる』,しかめづらをする《+『at』+『名』》 / (…に)難色を示す,(…を)好まない《+『on(upon)』+『名』(a person's doing)》 / 〈怒り・不賛成など〉‘を'まゆをひそめて示す 
froze	 freezeの過去形 
fruit	 〈U〉〈C〉『果物』,(植物の)実,果実 / 《複数形で》『農作物』(果物・穀物・野菜など) / 〈U〉〈C〉《しばしば複数形で》『成果』,結果 / 実を結ぶ
frump	 (特にオールドミスなど)流行遅れの服装をしている女性 
fudge	 ファッジ(砂糖・ミルク・バタ・チョコレートに香料を入れて柔らかに固めて作ったキャンデー) / (…について)煮えきらない態度をとる《+『on』+『名』》 / …‘を'ごちゃまぜにする 
funky	 (ジャズ音楽が初期の)素朴さのある / 《俗》上等の
furze	 ハリエニシダ(《英》gorse) 
fused	 ヒューズのついた 
fusty	 (部屋・着物などが)かび臭い,むっとする / (考え方などが)古風な,古くさい
gable	 破風(はふ),切り妻(屋根の斜目を2辺とした三角形の外壁部) 
gamin	 浮浪児 
gamut	 《しばしばthe ~》あらゆる種類(の…),(…の)全領域《+『of』+『名』》 / 全音階,全音域
gaudy	 (色彩などが)けばけばしい,俗っぽくはでな 
gaunt	 (飢え・疲労・病気などで人が)ひどくやせた / (土地・場所が)荒涼とした,寒々とした
gauze	 ガーゼ 
gauzy	 紗(しゃ)のような;(ガーゼのように)透いて見える 
gavel	 (議長・裁判官・せり売り人などが用いる)つち 
gawky	 ぶざまな 
gazer	 見詰める(凝視する)人 
gecko	 ヤモリ(ヤモリ科の爬虫類) 
genus	 (生物分類上の)属(family(科)の下でspecies(種)の上) / (一般に)種類
getup	 (物の)作り,体裁 / 身なり;(特に)いっぷう変わった服装
ghost	 『幽霊』,亡霊,死者の霊 / (…の)ほんのわずか《+『of』+『名』》 / (…の)幻,面影《+『of』+『名』》 / =ghost writer / (テレビの画面の)ゴースト / =ghostwrite
ghoul	 イスラム諸国の伝説で墓に埋められた死人の肉を食うという悪霊 / (一般に)墓場荒らし / 残虐な行為(ぞっとするようなこと)を楽しむ人 
giant	 『大男』;(物語・伝説の)『巨人』 / 『大人物』,偉人 / 『巨大な物』 / 巨大な,ものすごく大きい
gipsy	 =gypsy 
girth	 〈C〉(馬などの)腹帯 / 〈C〉〈U〉(木の幹などの)周囲の寸法;(人の)胴回り[の寸法] / (馬などの背に)〈くらなど〉‘を'腹帯で締める / …‘を'取り巻く
gismo	 =gizmo 
given	 giveの過去分詞 / 定められた,一定の;(数学などで)与えられた / 《補語にのみ用いて》(…)する癖がある,(…に)熱中する《+『to』+『名』(do『ing』)》 / (公文書で何月何日に)作成された,交付された / …と仮定すると,もし…とすると / …があれば;…を考慮しても
giver	 与える人,寄贈者 
gizmo	 仕掛け;妙案,工夫 
glace	 (果物など)砂糖をかけた / (布・皮などが)なめらかで光沢のある
glade	 森(林)の中の空き地 
gland	 (生物体内の)腺(せん) 
glans	 陰茎(陰核)亀頭(きとう) 
glare	 〈太陽などが〉『ぎらぎら光る』,まぶしく輝く / (…を)『にらみつける』《+『at(on, upon)』+『名』》 / 〈敵意など〉‘を'にらみつけて表す / 『ぎらぎらする光』,まぶしい光 / 『にらみつけ』 / 非常に目立つこと,けばけばしさ,どぎつさ
glaze	 …‘に'ガラスをはめる,〈建物など〉‘に'ガラス窓を付ける / 〈焼き物〉‘に'うわ薬をかける;〈革・紙など〉‘に'つや出し加工をする / 〈目〉‘を'どんよりさせる / 〈食物〉‘に'照りをつける / 〈目が〉どんよりする《+『over』》 / 〈焼き物などの)つやのある表面,表面のつや;(料理の)てり / うわ薬 
gleam	 (…の)『きらめき』,輝き;(…の)『薄明かり』,微光《+『of』+『名』》 / (希望・機知・感情などの)『ひらめき』,かすかな表れ《+『of』+『名』》 / 『きらめく』;かすかに光る / 〈希望・感情などが〉ひらめく
glean	 〈小麦など〉‘の'落ち穂を拾う;〈田畑など〉‘から'落ち穂を拾う,採り残しを集める / 〈知識・情報など〉‘を'こつこつと集める
glide	 《副詞[句]を伴って》『滑る』,滑るように(すうっと)進む,音もなく動く / 〈時が〉いつの間にか過ぎる《+『along』(『away,on,by』)》 / 〈グライダー・飛行機が〉滑空する / 滑り,滑走;(飛行機の)滑空 / グライド(ダンスの滑るようなステップ) / (音声で)わたり音
glint	 きらり(ぴかり)と光る / きらめき,きらりとした光
gloat	 (…を)満足げに(小気味よさそうに)眺める《+『over』(『on, upon』)+『名』(do『ing』)》 
globe	 〈C〉『球』,球体 / 《the ~》『地球』(the earth) / 〈C〉『地球儀』 / 〈C〉球形のガラス器(ガラス鉢・ランプのほや・金魚鉢など)
glory	 〈U〉『光栄』,名誉 / 〈U〉『壮観』,荘厳,美観 / 〈U〉(神の)『賛美』 / 〈U〉『繁栄』,全盛,絶頂;大得意 / 〈C〉《しばしば複数形で》誇りとなるもの,みごとなもの / 〈U〉天国 / 《『glory in』+『名』(do『ing』)》(…を)喜ぶ;(…を)誇りする,得意がる 
glove	 (五指の分かれている)『手袋』 / (野球の)『グローブ』;(ボクシング用の)グラブ / …‘に'手袋をはめる / (野球で)〈ボール〉‘を'グローブで捕る
gloze	 …‘を'うまく言い逃れる,言いつくろう《+『名』+『over,』+『over』+『名』》 
gluey	 にかわ質(状)の,にかわのようにねとねとする 
gnarl	 (木の)節(ふし),こぶ 
gnash	 (特に怒りや苦痛のために)〈歯〉‘を'きしませる / 〈人が〉歯ぎしりをする;〈歯が〉きしる
gnome	 ノーム,地の精(地下に住んで地中の宝を守るといわれる年老いた小人) 
godly	 信心深い 
gonad	 性腺(せん),生殖腺 
goner	 見込みのない人(もの);生けるしかばね,廃人 
gorse	 ハリエニシダ(黄色い花をつける低木) 
gourd	 ヒョウタン,フクベなどウリ科の植物 / ヒョウタンの実
gouty	 痛風の,痛風にかかった 
grace	 〈U〉(形・動作などの)『優雅さ』,洗練 / 〈U〉〈C〉食前(食後)の短い祈り / 〈U〉(…する)『思いやり』,親切《+『to』do》 / 〈U〉(神の)恩ちょう,恵み / 〈U〉恩恵,恩典;猶予,(特に負債などの)支払い猶予 / 《複数形で》(人の)美点,長所,魅力 / 〈C〉《G-》《Your,His,Herを伴って》閣下,閣下夫人 / 《the Graces》(ギリシア神話の)美の三女神 / …‘を'優雅にする,美しく飾る 
grade	 《米》(小・中・高校の)『学年』(小学校から12年まで通算する) / 《おもに米》(学業の)『成績』,評点 / (位階・品質・価値などの)『階級』,『等級』 / 《米》(道路・線路などの)傾斜,勾配(こうばい)(《英》gradient) / …‘を'『等級分けする』,‘の'格づけをする / 《米》…‘の'採点をする / 〈道路など〉‘の'勾配(こうばい)をゆるくする / 等級別になる,徐々に変わる,〈色彩などが〉次第に他の色に移る
graft	 (つぎ木の)つぎ穂;つぎ木 / (皮被・内臓・骨などの)移植片 / (木に)〈つぎ穂〉‘を'つぐ,(体に)〈移植片〉‘を'移植する《+『名』+『on』(『upon』,『in』,『into』)+『名』》 / …‘を'結合させる《+『名』+『together』》 / (…に)つぎ木する,移植する《+『on』(『upon』,『in』,『into』)+『名』》 
grain	 〈C〉(穀類の)『粒』《+『of』+『名』》 / 〈U〉《集合的に》『穀物』,穀類 / 〈C〉(砂・塩などの)粒《+『of』+『名』》 / 〈C〉《おもに否定文で》『ごく少量』,ほんの少し(の…)《+『of』+『名』》 / 〈C〉グレーン(最小の重量単位で約0.0648グラム;《略》『gr.』,『g.』) / 〈U〉(木・石などの)きめ,はだ,木目(もくめ),石目
grand	 『壮大な』;豪壮な / 《名詞の前にのみ用いて》『威厳のある』,気高い / (順位などが)最高の / 重大な,重要な / 《名詞の前にのみ用いて》全体の,全部を合わせた(complete) / 《話》すてきな,すばらしい / 尊大な,うぬぼれた / =grand piano / 《米俗》1,000ドル 
grant	 〈人の願いなど〉『‘を'かなえる』,聞き入れる / 《文》(特に正式に)〈許可など〉『‘を'与える』,〈権利・年金など〉‘を'授与する,授ける / 〈事柄など〉『‘を'認める』 / 〈C〉(…への,…からの)補助金,奨学金《+『to』(『toward,from』)+『名』》 / 〈U〉(…の)授与,交付;(…の)許可,承認《+『of』+『名』》 
grape	 『ぶどう』 / =grapevine
graph	 グラフ,図表 
grasp	 …‘を'『しっかり握る』,『ぎゅっとつかむ』 / …‘を'『理解する』,把握する / (…を)捕まえ(捕らえ)ようとする《+『at』(『for』)+『名』》 / 《通例a~》(手などでしっかり)『捕まえること』,『つかむこと』 / 『理解』[『力』],知的把握[力] 
grate	 (窓などの)格子;(暖炉の)火格子 / 暖炉 / …‘に'格子をつける 
grave	 『墓穴』;(一般に)埋葬所,墓 / 《しばしばthe grave》死(death);滅亡
gravy	 グレービー(肉を焼くときに出る肉汁,またそれをもとにして作った肉汁ソース) / 《俗》楽に手に入った金,あぶく銭
graze	 〈家畜が〉『牧草を食う』,草を食う / 〈家畜が〉(草などを)食(は)む《+『on』+『名』》 / 〈家畜〉‘に'『牧草を食べさせる』;〈家畜〉‘を'放牧する / 〈草原〉‘を'牧場に使う / 〈家畜が〉〈生草〉‘を'食う 
great	 (規模・範囲などが)『大きい』,巨大な / 『多数の』;『多量の』 / 『偉大な』,すぐれた;《the Great》《称号・肩書に用いて》 / (身分・地位などの)高い / 気高い,崇高な / 《名詞の前にのみ用いて》重要な,重大な / 《人を表す名詞の前にのみ用いて》大の,たいへんな / 《話》すてきな,すばらしい / 《名詞的に》《the great》偉大な人たち,重要人物 / とても,すごく / とてもよく(very well) / 大物,花形
grief	 〈U〉(…についての)『深い悲しみ』,悲嘆《+『at』(『for』,『over』,『about』)+『名』》 / 〈C〉(…にとっての)悲しみのもと,嘆きの種《+『to』+『名』〈人〉》
grime	 (表面にこびりついた黒っぽい)汚れ,あか,すす / (あかなどで)…‘を'汚す《+『名』+『with』+『名』》
grimy	 汚れた,あかじみた,すすけた 
grind	 (粉などに)〈穀物など〉‘を'『ひく』,細かく砕く《+『名』+『into(to)』+『名』》 / (…から)〈粉など〉‘を'『ひいて作る』《+『名』+『from』+『名』》 / 〈ナイフなど〉‘を'研ぐ;〈レンズなど〉‘を'磨く / …‘を'『きしらせる』;(…に)…‘を'こすりつける《++『名』+『into』(『under』)+『名』》 / 〈人・圧制・貧困などが〉〈人・心など〉‘を'苦しめる,圧迫する《+『名』+『down,』+『down』+『名』》 / 〈回転式器具〉‘の'ハンドルを回す / 《話》(人の頭などに)〈学科など〉‘を'たたき込む,詰め込む《+『名』〈学科〉+『into』+『名』》(学科などで)〈人〉‘に'骨折って教え込む《+『名』〈人〉+『in』+『名』》 / 〈穀物などが〉(よく,細かく)ひける,粉になる / ギーギーすれ合う,きしる / 《米話》(…を)こつこつ勉強する(働く)《+『away at』(『for』)+『名』》 / 〈U〉粉にひくこと;研ぐこと / 〈U〉(コーヒーなどの)ひいた粒の大きさ / 〈C〉《話》つらくて退屈な勉強(仕事) / 〈C〉《米話》がり勉屋,がりがり仕事をする人
gripe	 《話》〈物事が〉〈人〉‘を'いらいらさせる,悩ます / 〉〈人〉‘を'激しい腹痛で苦しめる。 / 《話》(…について)絶えず不平を言う,ぼやく《+『about』(『at,over』)+『名』(do『ing』)》 / 激しく腹が痛む / 〈C〉《話》(…についての)不平,苦情,ぼやき《+『about』(『at,over』)+『名』》 / 《the gripes》激しい腹痛
grist	 製粉用の穀物;ひき割り 
grits	 外皮をとってあらくひいた小麦(エンバクなどの穀物) / 《米》グリッツ(オートミールに似た穀物食の一種で,かゆ状にした白いあらびきとうもろこし)
groan	 (苦痛・悲嘆などで出す)『うなり声』,うめき声 / 不平(不満,不賛成,あざけりなど)のうめき声 / ギーッときしむ音 / (苦痛・悲嘆などで)『うめく』,うなる《+『with+『名』》;(圧倒・重荷などに)うめき苦しむ《+『under』+『名』 / うなるような音を出す,うめきに似た声を出す / 〈棚・テーブルなどが〉きしむほど(…を)載せている《+『with』+『名』》 / 〈話・言葉〉‘を'うめきながら言う,うめくように言う《+『out』+『名』,+『名』+『out』》 / 〈人〉‘を'不満(非難)の声で黙らせる《+『down』+『名』,+『名』+『down』》
groat	 (17世紀中ごろまで用いられた英国の)ペンス銀貨 
groin	 鼠蹊(そけい)部 / 穹稜(きゅうりょう)(円形天井の相交わる稜線)
grope	 手探りする / …‘を'手探りで見付ける / (暗がりで)手探りすること 
group	 (…の)『群れ』,集まり,小集団《+of+名》 / (主義・系統・種類などを同じくする人・物の)『派』,『団体』 / (ポミュラーソング歌手の)グループ / (動・植物分類上の)群;(化学の)基,原子団;(地質学上の)界;(数学の)群;(言語学上の)語派 / …‘を'一群に集める,一団にする《+『名』+『together』》 / (系統的に)…‘を'分類する,調和よく配合する《+『名』+『together』》 / 集まる,群(集団)をなす 
grout	 (石の接合に用いる)うすとろ,セメント糊(のり) 
grove	 『小さい森』(『林』),木立ち 
growl	 〈動物が〉『うなる』,ウーッという / (…に)〈人が〉怒ってうなるように言う《+『at』+『名』》 / ゴロゴロ(ガラガラ)と音を立てる / …‘を'うなって言う《+『out』+『名,』+『名』+『out』》 / うなること,うなり声 / うなり声に似た音
grown	 growの過去分詞 / 成長した,大きくなった / 《複合語を作って》「…の茂った」「…産の」の意を表す 
gruel	 (湯または牛乳で料理したオートミールなどの)薄いかゆ 
grunt	 〈豚が〉ブーブー鳴く / 〈人が〉ブーブー言う / …‘を'ぶつぶつ言う,不平がましく言う / ブーブー言う声
guano	 グアノ(海鳥のふんのたい積したもので,肥料になる) 
guard	 〈C〉『見張り』,番人;歩哨(ほしょう),番兵;護衛兵 / 〈U〉(…を)見張ること,監視すること《+『over』+『名』》;(…を)警戒(用心)すること《+『against』+『名』》 / 〈C〉《英》(列車・電車の)『車掌』(《米》conductor) / 《the Guards》《英》近衛(このえ)連隊 / 〈U〉〈C〉(ボクシング・フェンシングなどで,相手の攻撃に対する)ガード,防御 / 〈C〉(米式フットボール・バスケットボールの)ガード / 〈C〉《しばしば複合語を作って》「(危険などを)防止する物,保護物」の輔を表す / …‘を'『見張る』,環視する / (…から)…‘を'『警戒する』,守る《+『against』(『from』)+『名』》 / (…に備えて)『警戒する』,用心する《+『against』+『名』(do『ing』)》
guest	 (食事・会合・滞在などへの)『招待客』,賓客・(ホテル・下宿などの)泊まり客,宿泊人,(レストランなどの) / (ラジオ・テレビなどの番組の)ゲスト,特別出演者 / (テレビなどに)ゲスト出演する《+『on』+『名』》 
guide	 〈人〉‘を'『案内する』 / (…のことで)〈人〉‘に'『助言する』,‘を'指導する,導く《+『名』+『in』+『名』》 / 〈仕事・行動など〉‘を'『監督する』,管理する;…‘を'思い通りに動かす,支配する / 『指導者』,『案内人』,ガイド / 『指標』,道しるべ;規律 / 『旅行案内』[『書』];(…の)『手引き』,入門書《+『to』+『名』》 / 誘導装置,(外科用探針の)導子 / 《英》Girl Guidesの一員
guild	 (中世の)ギルド / (一般に)同業組合,組合,協会
guile	 悪知恵,ずるさ,こうかつ 
guilt	 『有罪』;『罪』;犯罪[行為] / 罪の意識,やましさ
guise	 外観,様子 / 見せかけ,うわべ
gulch	 峡谷 
gumbo	 〈C〉=okra / 〈U〉オクラのスープ
gushy	 感情を大げさに表す;ひどく感傷的な 
gusto	 (何かをする)大きな喜び(楽しみ) 
gusty	 風の吹きすさぶ 
gutsy	 《話》勇敢な,大胆な,腹のすわった 
habit	 〈C〉 / 〈U〉〈C〉(個人の)『習慣』;(動・植物の)習性 / 〈C〉(麻薬などの)常用癖 / 〈C〉(僧衣など,特殊な)衣服
hadji	 =hajji 
hadst	 =had, haveの二人称単数・過去形 
hairy	 毛深い,毛だらけの・粗い,ざらざらした・《俗》 ぞっとするほど危険な; 困難な，難しい 
halve	 …‘を'半分に分ける / (人と)…‘を'半分ずつ分け合う《+『名』+『with』+『名』〈人〉》 / …‘を'半減する 
handy	 『取り扱いに便利な』,手ごろな,重宝な / 《話》すぐ手元の,すぐ使える(at hand) / (人が)『器用な』,手先の達者な;(…を)巧みに使う《+『at』(『about, with』)+『名』》 
haply	 多分 
hardy	 (人・動物が)『がんじょうな』(strong);耐久力のある / (植物などが)耐寒性の
harem	 〈C〉ハレム(回教国の婦人部屋) / 〈U〉《集合的に》ハレムの女たち
haste	 『急ぎ』(hurry);『あわてること』,軽はずみ 
hasty	 『急ぎの』,急な,せわしい / 『早まった』,せっかちな
haulm	 (穀類・豆類など脱穀後の)茎 
haunt	 …‘に'『しばしば行く』 / 《しばしば受動態で》(幽霊などが)…‘に'出没する / 《通例受動態で》〈考え・思い出などが〉〈人・人の心〉‘に'『付きまとう』 / 人がよく行く場所,人の集まる所
haven	 安全な所,避難場所 / 《まれ》港
haver	 くだらないおしゃべりをする 
havoc	 (自然の力・暴動などによる)大破壊,荒廃,大混乱,大騒ぎ 
hazel	 〈C〉ハシバミ;ハシバミの実(食用になる) / 〈U〉ハシバミ色,淡かっ色 / ハシバミ色の 
heady	 せっかちな,向こう見ずな / (酒などが)頭にくる / 気分を浮き立たせる 
heard	 hearの過去・過去分詞 
heart	 〈C〉『心臓』;胸 / 〈C〉(感情の中心をなす)『心』,気持ち / 〈U〉愛情,同情 / 〈U〉『勇気』,元気,熱意 / 《the ~》『中心』,内部,(物事の)本質,核心 / 〈C〉ハート形の物;(カードの)ハートの札
heavy	 『重い』,重量のある / (分量・程度・規模・強さなどが)『激しい』,大きい, / 『厳しい』,耐えがたい,つらい / 悲しい,陰気な / (動作が)のろい,ぎこちない / ものうい,だるい / (空が)曇った,うっとうしい,(海が)荒れた / (食物が)消化の悪い / 敵役,悪役 
hefty	 (物が)重くて動かせない,重い / 大柄でたくましい,屈強な,強力な;ばかでかい
heist	 (特に押し入って)…‘を'盗む / (特に)押し込み強盗
helix	 らせん / らせん形のもの
helot	 (古代スパルタの)奴隷 / ばかにされる人
heron	 アオサギ 
hertz	 ヘルツ(毎秒1サイクルに相当する周波数の単位;{略}Hz) 
hiker	 徒歩旅行者,ハイカー 
hinge	 (ドアなどの)『ちょうつがい』 / ちょうつがいのような働きをするもの(ひじやひざの関節など);かなめ / …‘に'ちょうつがいを付つける,‘を'ちょうつがいで取り付ける / チョウツガイで働く / (…に)よる,(…)次第である《+『on』(『upon』)+『名』(do『ing』)》 
hives	 発しん,じんましん 
hoard	 (財宝などの)秘蔵;(食物などの)秘密の蓄え,買いだめ《+『of』+『名』》 / (ひそかに)…‘を'貯蔵する,貯蓄する,ため込む
hoary	 (髪が)白い,(頭が)白髪の / 古い
hogan	 ホーガン(北米Navajoインディアンの住居) 
hoist	 〈旗・帆など〉‘を'『揚げる』,揚げる;(綱・起重機で)〈重い物〉‘を'引き上げる / 引き上げ,持ち上げ,掲揚 / 巻き上げ機,起重機 
hokum	 でたらめ,たわごと / (劇・小説などの)おきまりの手(節)
homer	 =home run / ホームランを打つ
honey	 〈U〉『はちみつ』;花のみつ,糖みつ / 〈U〉(みつのように)甘いもの;心地よいこと / 〈C〉《おもに米話》かわいい人 / 〈C〉《おもに米話》りっぱなもの / はちみつの;(味・色が)はちみつのような,はちみつ入りの / 〈食物など〉‘を'はちみつで甘くする / 《話》〈人〉‘に'甘い言葉をかける,おせじを言う 
horde	 (中央アジア草原地方の)遊牧民の群れ,遊牧民族 / (…の)群衆《+『of』+『名』》 / (動物などの)大群《+『of』+『名』》 
horny	角製の,角のような物軸でできた / 角のある,角のようなもののある / 角のように堅い・欲情している・性的に興奮してムラムラしている、性欲をかき立てられている、発情している、やりたがっている 
horse	 〈C〉『馬』,(特に成長した)雄馬 / =vaulting horse / 〈C〉(物を載せたり,支えたりする)脚付き枠(台など),掛け台,のこひき台,きゃたつ / 〈U〉《集合的に;複数扱い》騎兵,騎兵隊 / 〈人〉‘を'馬に乗せる;〈馬車〉‘に'をつける 
hotel	 『ホテル』,旅館 
hotly	 暑く,熱く / 激しく,熱心に / おこって 
hound	 『猟犬』;(特に)キツネ狩り犬 / 卑劣な男;嫌われもの / (猟犬のように)…‘を'追跡する / 〈人〉‘に'しつこく言う,‘を'悩ます
houri	 (イスラム教で)楽園にいて喜びを与える美少女, 魅惑的な女性, 売春婦 
house	 『家』,住宅 / 家庭,家族,世帯 / 《しばしば複合語を作って》(ある特定の目的に用いる)建物 / (劇場などの)観客,聴衆 / 《しばしばthe H-》議会,立法府,議院 / 《しばしばH-》(王侯貴族の)家系,…家 / 〈人〉‘に'住居を提供する;〈人〉‘を'泊める,収容する / 〈品物〉‘を'しまう,蓄える / 家の / (特定の会社などの)社員向けの
hovel	 物置,家畜小屋 / あばら家,堀っ建て小屋(hut)
hover	 〈鳥・ヘリコプターなどが〉空に浮かぶ;(…の上を)舞う《+about(above, over)+名》 / 〈人などが〉(…の周辺を)うろつく,(…に)つきまとう《+about(around, near)+名》 / (…の間の)さまよう,ぐらつく《+between+名》 
howdy	 よう,やあ(あいさつの表現)(hello, how do you do?) 
human	 (動物・神に対して)『人間の』,人の / 『人間らいし』,人間的な,人情味のある / 〈C〉《複数形》(動物に怠して)人間(human being) / 〈U〉《the human》人類
humid	 (空気・天候などが)湿気のある,湿っぽい(damp) 
hunky	 =honky 
husky	 エスキモー犬(Eskimo dog) 
hying	 hieの現在分詞 
hyrax	 ヒラックス,ハイラックス(ウサギに似たひづめのある小動物) 
ichor	 イコル(ギリシア神話で神の体中を流れているとされる霊液) 
ictus	 (詩の韻律で)強音,揚音 
ideal	 『理想』,究極の目的 / 理想の人物(物),(理想とすべき)手本 / 『理想的な』,申し分のない / (実在ではなく)観念的な,頭の中だけの;想標上の
idler	 怠け者,役立たず 
ileum	 回腸(小腸の下部の1/3の部分) 
image	 (鏡に映った)『像』,(レンズによる)映像 / (心に浮かぶ)『像』,心像,イメージ / (絵・彫刻などによる人・動物などの)『像』,肖像;偶像《+『of』+『名』》 / (…に)『そっくりの人』(『物』)《+『of』+『名』》 / (…の)典型;(…の)化身《+『of』+『名』》 / (直喩(ちょくゆ)・隠喩などの)比喩 / …‘の'像を描く;…‘を'思い描く 
imago	 (昆虫の)成虫 
imbed	 =embed 
imbue	 《受動態で》(思想・感情などを)〈人,人の心〉‘に'しみ込ませる,吹き込む / (水分・色などを)…‘に'しみ込ませる
impel	 〈ある考え・感情などが〉〈人〉‘を'駆りたてる(urge) / (…へ)…‘を'押し進める《+『名』+『to』+『名』》
imper	 imperative 
imply	 …‘を'『ほのめかす』,暗に示す / …‘を'意味を含む,…[の存在]‘を'当然の前提とする
inapt	 不適当な,適切でない;(…に)適さない《+『for』+『名』》 / 《補語にのみ用いて》(…が)へたな,不手際な《+『at』(『in』)+『名』》
incur	 〈損害・非難・危険など〉‘を'招く,こうむる 
index	 (本・雑誌などの)『索引』;図書目録 / 指し示すもの,印 / (計器などの)指針 / 指数・虜 / 《the I-》(カトック教会の)禁所目録 / 〈本など〉‘に'索引をつける / 〈語など〉‘を'索引に載せる 
indue	 =endue 
inept	 不適当な,時(所)を心得ない / (…に)手際の悪い《+『at』+『名』(do『ing』)》
inert	 (物質・物体が)活動する力がない / 化学作用を起こさない / 鈍い,のろまな,不活発な 
infer	 …‘を'『推論する』,推量する 
infra	 (書物・論文で)以下に,下に,あとに 
ingot	 (金属の)鋳塊,鋳棒 
inlay	 (金・銀・象牙(ぞうげ)などを)…‘に'はめ込む,象眼する《+『名』+『with』+『名』》;(…に)〈金・ 銀・象牙など〉‘を'はめ『込』む《+『名』+『into』(『in』)+『名』》 / 〈U〉〈C〉象眼模様,象眼材料 / 〈C〉インレー(金属・陶材の歯の充てん物) 
inlet	 入り江 / (水などの)入り口
input	 投入,投入量 / (機械・電気)などの入力 / インプット(電子計算機の入力) 
inset	 (…に)…‘を'挿入する《+『名』+『in』(『into』)+『名』》;(…を)…‘に'差し込む《+『名』+ 『with』+『名』》 / (新聞・書物の)差し込みページ;(大きな図表・地図などの中にはめ込まれた)差し込み図(地図,絵)
inter	 〈死体〉‘を'埋葬する 
inure	 (…に)〈人〉‘を'慣れさせる《+『名』〈人〉+『to』+『名』(do『ing』)》 
irate	 怒った,怒りの 
irony	 〈U〉『皮肉』,『風刺』;反語[法] / 〈C〉(運命の)皮肉,(具体的な事例としての)皮肉な成り行き
islet	 小島 
itchy	 かゆい,むずむずする / 欲しがる,うずうずする
ivory	 〈U〉『象牙』(ぞうげ) / 〈C〉《しばしば複数形で》象牙製の物 / 〈U〉象牙色 / 象牙の[ような];象牙色の
jaunt	 (遊びのための)小旅行 / 小旅行に出る
jerky	 がくんがくん(ガタガタ)動く;けいれんする / (話などが)とぎれとぎれの / 《米俗》(人・そのふるまいなどが)ばかな,愚かな,ばかげた 
jihad	 (イスラム教を守るための)聖戦 / (思想や主義のための)運動
jingo	 強硬外交論者,盲目的愛国者,主戦論者 
jinks	 浮かれ騒ぎ 
joint	 『関節』 / 『継ぎ目』,接合箇所,合わせ目 / 継ぎ目と継ぎ目の間の部分,節 / (二つの部分を継いだり支えたりするのに用いる)継ぎ手,ジョイント / (枝や葉の)つけ根,節 / (骨付きの)肉の大切り身 / 《俗》安酒場,とばく宿,アヘン窟(くつ) / 『共同の』,共有の;連帯の,連合の / 両院合同の;二院制議会の両院の / …‘を'継ぎ合わせる;…‘を'継ぎ目(関節)でつなぐ / …‘を'継ぎ目で分ける;〈鳥・肉など〉‘を'関節で切り分ける 
joist	 (床板や天井を支える)はり,けた,根太(ねだ) 
joker	 冗談を言う人,おどけ者 / (カードの)ジョーカー
jolty	 ガタガタ揺れる,がたつく 
joule	 ジュール(エネルギー・仕事の単位) 
joust	 (中世の騎士の)馬上やり試合 / 馬上やり試合をする
judge	 『裁判官』,判事 / (競技・コンテストなどの)『審査員』,審判 / (…の)『鑑定家』,目のきく人,(物事の)よしあしの分かる人《+『of』+『名』》 / 〈人・事件〉‘を'『裁判する』 / 〈競技など〉‘を'『審判する』,〈コンテストなど〉‘を'審査する / 〈人・物事〉‘を'『判断する』,『評価する』;…‘と'[判断して]思う / (…で…を)判断する,評価する《+『of』+『名』+『by』+『名』》 / (裁判官・審判などとして)(…を)裁く,判定する;(…の間の)優劣を判定する《+『between』+『名』》
juice	 〈U〉〈C〉(果物・野菜・肉などの)『汁』,『液』,ジュース;〈U〉(植物の)樹液 / 《複数形で》(動物の)体液,分泌液 / 〈U〉《俗》電気;ガソリン,燃料オイル / …‘から'汁をしぼり取る
juicy	 (果物などが)汁の多い / 《話》(スキャンダルなどが)興味しんしんの
julep	 =mint julep 
jumbo	 巨大な人(もの・動物);ジャンボジェット機 / 巨大な,でかい
jumpy	 びくびくした,ひどく神経質な / はね上がる,跳びはねる;ぴくぴく動く
junco	 ユキヒメドリ(北米産のヒワの類の鳥) 
junta	 (特に,クーデター直後の,合法的政権ができるまでの)暫定政府,臨時政府 / (特にラテンアメリカの)議会,会議
junto	 (持に政治的目的を持つ)徒党,秘密結社 
kaput	 だめになって,壊れて 
karst	 カルスト地形(浸食された石灰岩台地) 
ketch	 ケッチ(2本マストの帆船) 
knave	 《古》悪漢,ごろつき / =jack3
knead	 〈練り粉など〉‘を'こねる / 〈筋肉〉‘を'もむ
knelt	 kneelの過去・過去分詞 
knife	 『ナイフ』,小刀;包丁;短刀 / (機械などの)刃 / …‘を'ナイフ(短刀)で切る(刺す) / (ナイフで)切るように進む
knish	 クニシュ(肉・じゃがいもなどの詰め物を入れて油であげたユダヤ料理) 
knout	 革むち(昔のロシアの刑具) 
kraut	 =sauerkraut・（軽蔑して）ドイツ人
krona	 (複‐nor)クローナ(スウェーデンの貨幣単位) / (複‐nur)クローナ(アイスランドの貨幣単位)
krone	 クローネ(デンマーク・ノルウェーの貨幣単位) 
kudos	 栄光;名声 
kwela	 クェイラ(南アフリカ黒人の踊りの音楽) 
laden	 ladeの過去分詞 / 荷を積んだ;(…を)積み込んだ《+『with』+『名』》 / 《補語にのみ用いて》(…の重さで)押し下げられた《+『with』+『名』》 
lager	 貯蔵ビール,(低温で数が月貯蔵したもので,日本の普通のビールもこの種類) 
laird	 (スコットランドの)地主 
laity	 (聖職者に対して)平信徒,俗人(layman, laywoman);(職業人・専門家に対して)専門外の人々,しろうと衆 
lance	 (槍騎兵(そうきへい)が突撃のときに使う)やり / (魚を突く)やす,もり / 槍騎兵(=lancer) / =lancet / …‘を'やりで突く / …‘を'ランセット(lancet)で切開する / …‘を'投げつける,投げ飛ばす 
lanky	 ひょろ長い,ひょろひょろした 
lapin	 〈C〉(去勢した雄の)ウサギ / 〈U〉その毛皮
lapse	 『ちょっとした誤り』(失策) / (時の)『経過』《+『of』+『名』》 / (道徳的に正しい道を)踏みはずすこと,堕落《+『from』+『名』》 / (…への)転落,(…に)陥ること《+『into』+『名』》 / (…が)しだいに消滅すること《+『of』+『名』》 / (道徳的に正しい道を)踏みはずす《+『from』+『名』》 / (ある状態に)陥る,なる《+『into』+『名』(do『ing』)》 / 消滅する,使われなくなる / (時が)過ぎていく 
larch	 カラマツ(黄葉の美しい落葉高木) / カラマツ材
large	 (同じ種類のものと比較して,形・体積・数量などが)『大きい』,多い,広い / (考えなどが)広範囲な,幅の広い,寛大な / 大きく / 自慢して,誇大に
largo	 (楽曲が)ラルゴの(で),きわめてゆるやかな(に) / ラルゴ調の楽章
laser	 レーザー(強力な可視光線を発生させる;医療,通信,軍事用) 
latch	 (ドアなどにつける戸締まり用の)『掛け金』,かんぬき / 〈ドアなど〉‘に'掛け金を掛ける / 〈ドアなどが〉掛け金が掛かる 
later	 《補語にのみ用いて》(人などが)(…するのが)『もっと遅い』《+『in』+『名』(do『ing』)》 / (時刻・時期が)『もっと遅い』,もっと後の / 後で,のちほど / (lateの比較級)(定刻・予定時間・他の人(物))より遅れて,遅く
latex	 ラテックス(ゴムの木などから出る乳状の液で塗料・接着剤に用いる) 
lathe	 旋盤 
laugh	 (声を立てて)〈人が〉『笑う』 / 〈目・口もとなどが〉うれしそうに笑う / 〈動物,特にハイエナなどが〉笑い声に似た声(音)を出す / …‘を'笑って言う / 《a+形容詞+laughを目的語にして》…‘の'笑い方をする / 〈人〉‘を'『笑う』 / 『笑い』;笑い声;笑い方 / 《話》笑いの種,冗談(joke)
layer	 《複合語を作って》(物を)積む人(物),置く人(物) / 卵を産む鶏・層;(ペンキなどの)一塗り;一皮 / (園芸で)取り木 / …‘を'層にする / 〈植物〉‘を'取り木する 
leach	 〈水など〉‘を'こす,ろ過する / (灰・土・鉱石などから)〈可溶成分〉‘を'こして取る《+『out』+『名』(+『名』+『out』)+『from』+『名』》
leafy	 葉の多い,葉の茂った / 葉から成る,葉でできた / 葉のような 
leaky	 漏る,漏れ口のある 
leant	 leanの過去・過去分詞 
leapt	 leapの過去・過去分詞 
learn	 〈知識・技術など,習慣・心構えなど〉‘を'『習う』,学ぶ,身に着ける / …‘を'『覚える』(memorize) / …‘を'聞いて知る / 習う,学ぶ,覚える / (…から…について)知る,聞く《+『of』+『名』+『from』+『名』》 
leash	 (犬などをつなぐ)皮ひも,綱,鎖(くさり) / 〈犬など〉‘を'皮ひもなどでつなぐ
least	 (littleの最上級;比較級はless) / (大きさ・程度が)『最も小さい』(『少ない』) / (重要性・身分が)最も低い / (大きさ・程度・重要性が)『最小』(『最少』,『最小限』)『の物事』 / 『最も少なく』(『低く』) 
lefty	 《話》左ききの人(選手) 
legit	 =legitimate 
lemon	 〈C〉;レモン;レモンの木 / 〈U〉レモン色(lemon yellow) / 〈C〉《米》無価値な物;商品、製品などの「はずれ」・不良商品・欠陥商品・《英俗》だめな人,魅力のない物(人) / レモンの(入りの,色の)
lemur	 キツネザル(マダガスカル島産のキツネに似た夜行性動物) 
lento	 (音楽が)おそい,ゆっくりした / ゆっくりと[演奏して]
letup	 (力・強度などの)ゆるみ,減少 / (仕事などの)休止,停止
lexis	 (特定の言語・分野・個人の)総語彙 
lidar	 光線レーダー, laser-infrared radar 
lifer	 無期刑囚 / 職業軍人
liger	 ライガー(雄のライオンと雌のトラの間に生まれた子) 
light	 〈U〉『光,光線』;明るさ / 〈U〉夜明け;日中;日光 / 〈C〉『明かり』(太陽・灯火など光を出すもの) / 〈U〉《時にa~》光輝(brightness),(目などの)輝き / 〈C〉(点火するための)火,火花 / 〈C〉明かり採り,採光窓 / 〈C〉《通例単数形で》(絵などの)明るい部分 / 〈U〉(…についての)知識,情報,理解《+『on』+『名』》 / 〈C〉(ものを見る)観点,見地;相 / 〈C〉この世に光を与える人;指導的な人物 / …‘に'『火をつける』《+『up』+『名』+『名』+『up』》 / …‘に'『明かりをつける』,‘を'照らす《+『up』+『名,』+『名』+『up』》 / 〈人〉‘を'明かりをつけて案内する / 〈表情など〉‘を'明るくする《+『up』+『名,』+『名』+『up』》 / 〈物が〉火がつく,点火する;明かりがつく《+『up』》 / 明るくなる,晴れ晴れする《+『up』》 / 『明るい』 / (色が)『薄い』
liken	 (…に)…‘を'たとえる《+『名』+『to』+『名』》 
limbo	 地獄の辺境(天国と地獄の間にあり,洗礼を受けないで死んだ子供,異教徒などの霊魂が住むとされる所)・拘留所; 無視; 忘却; 不安定, 中間（の状態）;〈C〉(なおざりにされ忘れ去られたものの)捨て場所 
limey	 英国人 / 英国水兵
liner	 (特に大洋航路の)定期船;定期航空機 / 線を引く(物);(目の周囲の化粧用の)ライナー / ライナー(水平に飛ぶ野球の打球) 
liney	 =liny, 線を引いた, 皺の多い, 線の多い 
lingo	 ちんぷんかんぷんの言葉(わけのわからない外国語・専門用語など) 
links	 《単数・複数扱い》=golf course / 《複数扱い》(海岸の)砂地
lithe	 (動作・体が)しなやかな 
litre	 =liter 
liven	 …‘を'活気づかせる《+『up』+『名』,+『名』+『up』》 / 活気づく《+『up』》
liver	 (ある態度で)生活する人;居住者 
lives	 lifeの複数形 
loamy	 ローム土壌の 
lobed	 (葉が)裂片がある / (体の器官に)葉(よう：lobe)がある / 耳たぶのついた;葉(よう)のある 
locum	 (医師・牧師などの)代行,代理 
locus	 (法律用語で)場所,位置 / (数学で,点が描く)軌跡)
loden	 ローデン(オーバーコートなどに用いる厚い防水布地) 
lodge	 (特に狩猟・登山などで用いる)『小屋』,『ロッジ』 / (公園・大きな建物などの入口にある守衛所),門衛所 / (共済組合・秘密結社などの)支部,支部集会所 / アメリカインディアンの小屋 / (動物,特にビーバーの住む)穴 / (一時的に,臨時に)〈人〉‘を'『泊める』 / 〈人〉‘を'『下宿させる』 / (当局などに)〈苦情など〉‘を'正式に申し出る《+『名』+『with』+『名』》 / (…に)〈弾丸など〉‘を'打ち込む《+『名』+『in』+『名』》 / (一時的に,臨時に)『泊まる』 / (…に)『下宿する』,間借りする《+『at』+『名』〈場所〉/『with』+『名』〈人〉》 / (…に)〈弾丸などが〉入ってとどまる,〈矢などが〉突きささる《+『in』+『名』》
lofty	 (山・塔などが)『非常に高い』,そびえ立つ / (思想・目的・感情などが)高尚な,高潔な
logic	 『論理学』 / 『論理』,論法 / 《話》いやおうを言わせぬ力,必然性 / 《話》もっともな考え
loran	 ロラン(航空機や船舶が無線で自分の位置を知る装置) 
loser	 負ける,(負けた)人,敗北者 
lotus	 ハス / ロータス(ギリシア神話でその実を食べると浮き世を忘れるという植物)
lough	 湖,入江 
loupe	 拡大鏡,ルーペ 
louse	 シラミ / 《俗》くだらないやつ
lousy	 シラミのたかった / 《話》いやな,ひどい,下劣な,鼻持ちならない / 《話》(…が)うんざりするほどある;(…で)いっぱい《+『with』+『名』》 
lover	 『誠する人』,恋人《複数形で》恋人同士 / (…の)『愛好家』,(…を)愛する人《+『of』+『名』》
lovey	 (呼びかけに用いて)おい,ちょっと,おまえ, = lovey-dovey 
lower	 (lowの比較級)『もっと低い』,(価格が)もっと安い / 《名詞の前にのみ用いて》『下級の』;低い(下の)ほうの / …‘を'『下げる』,降ろす / 〈価格・程度・量・調子など〉‘を'『下げる』,小さくする,低下させる / 〈人〉‘を'品位(品格)を落とす / 低くなる,下がる,滅る
lucid	 分かりやすい,明快な(clear) / 正気の(sane) / 透き通った,透明な(transparent) / 《詩》明るい,輝いた(bright)
lucky	 『幸運の』,運のよい / 幸運をもたらす
lucre	 (悪い意味で)利得,金もうけ,金銭 
lumpy	 塊の多い;(表面が)でこぼこの,ごつごつの / (動作が)のろのろした,鈍重な / (水面が)波立っている,荒れた 
lunar	 年の,年に関連する 
lunch	 〈U〉『昼食』 / 〈C〉〈U〉 / 『軽食』,弁当 / 昼食を食べる
lunge	 (ナイフなどの突然の)突き刺し;(体などの)突進 / 突き刺き,突進する / …‘を'突き刺す 
lurch	 (船・車などが)急に前後(左右)に動くこと / (人の)よろめき,千鳥足 / 〈船などが〉急に揺れる;〈人が〉よろめく 
lurgy	 《英》病気(illness, disease) 
lurid	 (空・雲などが)赤々と輝く;(色などが)けばけばしい / ぞっとする;恐ろしい;ものすごい(terrible)
lusty	 (身体の)強壮な;元気あふれる,活発な / 好色の
lying	 lieの現在分詞 
lymph	 リンパ[液] 
lynch	 …‘に'私刑(リンチ)を加える 
lyric	 叙情[詩]の;叙情的な / 歌の,歌を用いた / 叙情詩 / 《複数形で》《特に歌謡曲の》歌詞
lysin	 リジン(細胞溶解素), = lysine 
macho	 強く男らしい男 / 強くて男らしい
madly	 気が狂って;狂乱して;熱狂して / 《話》非常に,猛烈に / 愚かにも 
magic	 『魔法』,魔術;呪術(じゅじゅつ) / 『手品』,奇術 / 心を奪う力,魔力;(…の)神秘的な魅力《+『of』+『名』》 / 魔法の / 手品の,奇術の 
magus	 古代ペルシアの僧 / 《文》魔術師
mains	 (水道・ガスなどが)本管から送られた,主電線からの 
maize	 とうもろこし / とうもろこし色,薄黄色
major	 『大きい』(『多い』)『ほうの』,いっそう重要な / (音階が)長調の,長音階の / 《英》《昔の学校で同姓または兄弟生徒を区別するために姓の後につけて》年長の,兄の / 《しばしばM-》陸軍(空軍)少佐 / 《米》専攻科目;専攻学生 / 《the majors》《米》=major leagues / (科目を)専攻する《+『in』+『名』》 
maker	 〈C〉『製作者』,作る人,メーカー / 《複合語を作って》…製造業者,…屋 / 《the M-,our M-》造物主,神(God) 
manes	 (ローマ教で)死者の霊 / 《単数扱い》(特定の死者の)霊;《複数扱い》祖先の霊
mange	 かいせん(犬・牛などがかかる皮膚病) 
mango	 マンゴー;その果実(南洋産の常緑高木で果実は美味) 
mangy	 (家畜が)かいせんにかかった / 《話》(衣服・場所などが)みすぼらしい,汚い
manic	 躁病(そうびょう)の,躁病にかかっている 
manly	 『男らしい』,勇ましい;男性的な;男まさりの 
manor	 (封建時代の領主の)領地;荘園 / (領主の)邸宅,(所有地・大農園などの)母屋(おもや)
manse	 (特にスコットランド長老教会の)牧師館 
maple	 『カエデ』,『モミジ』;〈U〉カエデ材(堅くて木目が美しく,家具用) 
march	 《方向・状態を表す副詞[句]を伴って》 / (歩調をそろえて)『行進する』,行軍する / 〈人が〉堂々と(ゆうゆうと)歩く / 〈事件などが〉進展する,進む / 《方向・状態を表す副詞[句]を伴って》 / …‘を'行進(行軍)させる / 〈人〉‘を'急いで連れて行く,追い立てる / 〈U〉『行進』,進軍;〈C〉行進距離;行軍行程 / 〈U〉《the march》(事件などの)『進展』,進行 / 〈U〉(兵隊の)行進歩調 / 〈C〉『マーチ』,『行進曲』 
marsh	 沼地,湿地(swamp) 
maser	 メーザー(マイクロ波増幅器) 
mason	 =stonemason / 《M-》=Freemason
match	 (1本の)『まっち』 / (昔の)火縄[銃]
matey	 親しみやすい,友好的な(friendly) 
matzo	 マッツォ(ユダヤ人が過ぎ越しの祭に食べるクラッカー状のパン) 
mauve	 薄紫色,ふじ色 / ふじ色の
maybe	 『たぶん』,おそらく,ことによると 
mayor	 『市長』;町長 
mayst	 =you may, mayの直説法二人称単数現在形 
mealy	 あら粉のような / あら粉の / あら粉でまぶした / (顔色が)血色の悪い,青白い
means	 〈C〉《単数・複数扱い》『方法』,『手段』 / 《複数扱い》『資力』,『財産』,富
meant	 meanの過去・過去分詞 
meaty	 肉の,肉のような / 肉の多い,肉付きのよい / 内容の充実した 
medal	 『メダル』,記念章;勲章 
media	 mediumの複数形 
medic	 医学生,インターン / 医学関係者;《特に米》衛生兵,看護兵
melon	 『メロン』[の実];〈U〉メロンの果肉 
menad	 =maenad 
merci	 （フランス語）ありがとう 
mercy	 〈U〉『慈悲』,寛大,あわれみ / 〈C〉《a~》ありがたいこと,感謝すべきこと
merit	 〈U〉『価値』,優秀さ;〈C〉《しばしば複数形で》(賞賛・ほうびに値する)功績,手柄,美点 / 〈C〉《複数形で》(訴訟などで,物事の)理非(問題になっている事柄そのものの良し悪し,ありのままの事実) / 〈賞・罰・非難など〉‘に'値する 
meson	 中間子(素粒子の1つ;陽子と電子の中間の質量) 
metal	 〈C〉(個々の)『金属』;〈U〉(材料としての)金属 / 〈U〉合金(真ちゅう,真銅など) / 〈U〉気性,気質 / 〈U〉《英》(舗装用・鉄道用の)砕石 / …‘に'金属をかぶせる / 《英》〈道路〉‘に'砕石を敷く
metro	 地下鉄 
miaow	 =meow 
micra	 micronの複数形 
midge	 蚊,(特に小さい)ブヨ 
midst	 中央,まん中 / =amid
might	 mayの過去形 / 《直説法で》《時制の一致により従節に用いて》 / 《仮定法で》 / 《現在の事実と反対の仮定》…『かもしれないのだが』;…してもよい / 《過去の反対の推量》…『したかもしれない』 / 《仮定法から転じて遠回しの表現で》 / 《可能性・推量》『ひょっとしたら』…『かもしれない』 / 《疑問文で》《不確実》いったい…だろうか / 《許可》…『してもよい』 / 《提案・依頼》…『してくれませんか』…してみてはどうだろうか / 《非難・不平》…『してもよさそうなものだ』 
milch	 乳を出す 
miler	 1マイル競走者(馬) 
milky	 乳白色の / 乳を含んだ;乳を出す / (液体が)不透明な;白濁した 
mince	 (ナイフで)〈特に肉〉‘を'細かく切る,刻む / (気どって)…‘を'控え目に言う,遠回しに言う / 《副詞[句]を伴って》〈特に男が〉上品ぶって小またに歩く / 気どって話をする
miner	 鉱夫,坑夫 
mingy	 けちな,けちけちした(stingy) 
minor	 『小さいほうの,少ない』 / (階級・地位・重要性などが)『劣ったほうの』,重要でない / 重大ではない / 未成年の / (音楽で)短調の / 未成年者 / (大学の科目・課程の)副専攻科目 / (音楽で)短調 / 《the minors》《米》=minor league 
minus	 …を引くと,を減ずると / 《話》…なしで,を失って,のない(without) / 『マイナスの』,負の(negative) / 《名詞の後にのみ用いて》…より少し低い(小さい,劣る) / ゼロ以下の / (また『minus sign』)負号,マイナス記号 / 負数 
mirth	 陽気な騒ぎ,笑いさざめき;陽気,愉快 
misdo	 …‘を'間違ってする,やり損なう 
miser	 『欲ばり』,けちん坊,守銭奴 
misty	 霧の深い,霧に包まれた / (目が涙などで)かすんだ / (輪郭などが)ぼんやりした;(記憶・考えなどが)おぼろげな,もうろうとした(vague) 
mitre	 =miter 
mixed	 (異なった成分(要素)のものが)混ざった,混合の,混成の / 男女混合の / 人種(宗教・国籍など)が違う人々の(から成る) 
mixer	 ミキサー(ジュース・コンクリートなどの混合器) / 《通例形容詞を前に伴って》《話》人付き合いの…な人 / 《話》(人々に交際のきっかけを与えるための)混合パーティー / 録音(録画)の調節者
modal	 様式の,形態上の / 《名詞の前にのみ用いて》(動詞の)法(mood)の,叙法の / =modal auxiliary 
model	 (通名縮小した)(…の)『模型』,ひな型《+『of』+『名』》 / 《単数形で》(…の)『模範』,手本《+『of』+(『for』)+『名』》 / (美術家・作家などの)モデル,ファッションモデル / (自動車・服装などの)型,式《+『of』+『名』》 / 《英》《単数形で》(…と)そっくりな人(物),(…の)生き写し《+『of』+『名』》 / 『模型の』,見本の / 『日範的な』,申し分のない / (ある材料で)…‘の'模型を作る,‘を'型どる《+『名』+『in』+『名』〈材料〉》 / (手本・型に合わせて)…‘を'作る《+『名』+『after』(『on, upon』)+『名』(a person's do『ing』)》 / 〈洋装・髪型などの〉‘の'モデルをする / (…で)(原型)を作る《+『in』+『名』》 / (ファッションショーなどで)モデルをする
mogul	 重要人物,大方て者 
moire	 波紋織の絹 / 波紋模様
moist	 『湿っぽい』,湿気を含んだ;《比喩(ひゆ)的に》涙でぬれた 
molar	 臼歯(きゅうし) 
money	 〈U〉『金』(かね),金銭;通貨 / 〈U〉(金銭的な)利益,もうけ;富,財産 / 《複数形で》(政府・公共事業などの)財源,基金(funds) 
month	 (また『calendar month』)(暦の上の1月から12月までのそれぞれの)『月』 / (ある日から翌月のその日までの)ひと月,1か月間 / (また『lunar month』)(太陰暦の)ひと月(月が地球の周りを1公転する期間;太陽暦では『solar month』) 
moped	 モペット(モータ付き自転車;低馬力で免許なしで運転できる) 
moral	 《名詞の前にのみ用いて》(人・行為などが)『道徳的な』,道徳を守る;(人が)善悪の区別がつく / 《名詞の前にのみ用いて》『倫理』(『道徳』)『上の』,道徳の(ethical) / 『教訓的な』,道徳を教うる / 精神的な / (物語・でき事などに含まれた)『教訓』,寓意(ぐうい) / 《複数形で》(社会の)モラル,風儀;(個人の)『素行』,
mores	 (特定の集団・社会の)慣習,しきたり 
mosey	 《米話》ぶらつく,うろつく 
motel	 モーテル(街道沿にある自動車旅行者の宿泊所)[motorとhotelの合成語] 
motif	 モチーフ / 文学・芸術作品の表現の中心となる主題 / 楽曲の主題 / デザインなどに繰り返して用いられる主模様
mould	 =mold 
moult	 =molt 
mound	 『盛り土』,塚;土手,古墳 / (自然の)『小さい丘』,小山 / (一般に)盛り上げたもの,堆積 / (野球の投手の)マウンド
mount	 …‘を'『登る』(ascend, climb) / 〈馬・車〉‘に'『乗る』,〈台の上など〉‘に'上がる,乗る / (馬などに)〈人〉‘を'『乗せる』《+『名』〈人〉+『on』+『名』》 / (…の上に)…‘を'『載せる』《+『名』+『on』+『名』》 / (…に)…‘を'据え付ける,はめる,取り付ける,はる《+『名』+『in』(『on』)+『名』》 / 〈劇〉‘に'舞台装置や衣装を用意する / 〈攻撃など〉‘を'仕掛ける;〈作戦など〉‘を'展開する / 『登る』,上がる《+『up』》 / 『馬』(乗用の動物)『に乗る』 / (数・量において)ふえる,(程度において)高まる,強まる《+『up』》 / 乗用の動物,(特に)馬 / 台紙;(宝石などの)台;(顕微鏡用の)スライド板
mourn	 (…を)『悲しむ』,嘆く,いたむ《+『over』(『for』)+『名』(do『ing』)》 / 〈死んだ人,その人の死など〉‘を'『嘆き悲しむ』,哀悼(あいとう)する
mouse	 『ハツカネズミ』(英米の家によく出没する小型のネズミ;ほが国の家に出没する大型のネズミはrat) / 《話》臆病者,内気な人 / 《猫が》ネズミを捜す(捕らえる) / 《人が》(…を)あさり歩く《+『about』+『名』》
mousy	 ネズミの / (色・においなどが)ネズミに似た / (人が)こっそりとした,おずおずした 
mouth	 (人・動物の物を食べたり,音を発する)『口』,口腔 / (口に似た)開口部;(袋・びんなどの)口,(銅穴・峡谷などの)入り口;河口,港口 / …‘を'大げさに口を動かし気どってしゃべる / 〈信じていないこと・理解していないこと〉‘を'口にする / …‘を'口に入れる,かむ,なめる 
mover	 動き人(物);動かす人(物) / 《米》引っ越し荷物運搬業者 / 発起人;動議提出者 
movie	 (また『motion picture, moving picture』)《米》『映画』;《しばしばthe movies》《集合的に》映画(《英》cinema);映画の上映 / 《複数形で》映画館(《英》cinema) / 《複数形で》映画産業 
mower	 (また『mowing machine』)(人が乗って動かす)草(穀物)刈り機 / (また『law mower』)芝刈り機 / 草(穀物)を刈る人 
mucky	 汚ない(dirty) / (天気が)ひどい
mufti	 (通常は軍服など制服を着ている人たちの)平服,服 
mulch	 根覆い(植物の根を保護するためのわら・枯れ葉・土の混合物) / …‘に'根覆いをかける
mulct	 罰金(penalty) / …‘に'罰金を科する / 〈人〉‘を'だまして(…を)奪う《+『名』〈人〉+『of』+『名』》 
munch	 …‘を'むしゃむしゃ食べる(かむ) / (…を)むしゃむしゃ食べる(かむ)《+『at』(『on』)+『名』》
mural	 壁の;壁に掛かった(描いた) / 壁画,天井画
murex	 ホネガイ(熱帯地方の海産巻き貝の総称;古代人はこれから紫色染料を採った) 
murky	 暗い;陰気な;曇った,霧(もや)がかかった 
mushy	 かゆのような;どろどろした / 《話》めめしい,感傷的な
music	 『音楽』 / 音楽作ぽ,楽曲 / 楽譜(musical score) / 美しい調べ,快い音
musky	 じゃ香のような;じゃ香の香りのする 
musty	 かび臭い,かびの生えた / (思想などが)陳腐な,古くさい(out-of-date)
nacre	 =mother-of-pearl 
nadir	 〈U〉《the~》天底(天体の1点から鉛直に下ろした地上の点) / 〈C〉《単数形で》最下点;どん底
naive	 (若き・経験不足から)〈人・言葉などが〉無邪気な,天真らんまんな,世間知らずな / 人を信じやすい,だまされやすい　日本語で「繊細な」という意味で「ナイーブ」使われることがありますが、英語では「ナイーブ」にそのようなニュアンスは含まれません。
naked	 (体の全部,または一部が)『裸の』 / 『はぎ取られた』,むき出しにされた / (目が)肉眼の,裸眼の / 《名詞の前にのみ用いて》(事が)赤裸裸の,あからさまの
nares	 鼻孔(びこう),単数形は「nare」 
narky	 ふきげんな 
nasty	 『意地悪な』,卑劣な / 『不快な』,いやな(unpleasant) / みだらな,下品な / 厄介な,ひどい
nates	 《複数形》しり,臀部(でんぶ) 
navel	 へそ / 中心(center)
neath	 《詞》=beneath 
negus	 ニーガス酒(ワイン・湯・砂糖・香料などを混ぜて作った飲料) 
neigh	 馬のいななき / 〈馬が〉いななく,ヒヒーンと鳴く
nervy	 《米話》ずうずうしい,厚かましい(bold) / 《英話》神経質な;神経衰弱の
nevus	 母斑(ぼはん)(先天性のあざ・ほくろ・そばかすなど) 
newly	 『最近』,近ごろ / 『新たに』,再び
newsy	 ニュース(話題)の多い / おしゃべりな
nexus	 連鎖;関係 / (文法で)主語述語関係
niche	 壁がん(像・花びんなどを置く壁のくぼみ) / (…に)ふさわしい場所(地位,仕事),適所《+『for』+『名』》
nifty	 しゃれた,いきな;うまくできた 
night	 〈C〉〈U〉『夜』,晩,夜間 / 〈U〉(夜の)暗やみ,夜蔭 / 〈U〉《文》(精神的に)まっ暗な状態(時),やみ / 〈C〉(特定の行事・目的に当てられる)晩,夜 / 『夜の』,夜間[用]の;夜勤の;夜行[性]の 
nitre	 =niter 
noble	 高貴の;貴族の / 高潔な,気高い / (姿・規模などが)壮大な,堂々とした;すばらしい / (金属が)腐食しない / 《複数形で》(特に中世の)貴族 
nobly	 身分高く,貴族にふさわしく / 気高く,壮大な,雄々しく
nodal	 節(こぶ)の[ような] 
noise	 〈C〉〈U〉(特に,大きなまたは不快な)『音』,物音 / 〈C〉〈U〉(街・往来などの)『ざわめき』,騒音,騒々しい声 / 〈C〉(一般に)物音 / 〈U〉(ラジオ・テレビなどの)ノイズ,雑音 / …‘を'広める,言い触らす《+『名』+『about』(『abroad, around』)》 / 音を立てる;大声で話す《+『about』(『around, abroad』)》
noisy	 (人・声などが)『やかましい』,騒々しい,(場所が)騒音に満ちている 
nomad	 《しばしば複数形で》遊牧民 / 放浪者
north	 《the~》『北』;北方 / 《the~,the N-》北部[地方],北方[地域] / 《the N-》米国の北部諸州(特にOhio川以北のMaryland州・Missouri州を含む諸州;南北戦争で南部同盟諸州と戦った) / 『北の』,北部の,北向きの;北からの / 『北に』,北方へ 
nosey	 =nosy 
notch	 (V字形の)刻み目 / 《米》山あい / 《話》段階(STEP),等級(degree) / …‘に'刻み目をつける / 《話》〈競技の得殿など〉'を'記録する,〈勝利〉'を'収める 
noted	 『有名な』,著名な 
novel	 『新奇な』,ざん新な 
nudge	 (注意などを引くために,特にひじで)…‘を'軽くつつく / (特にひじで)軽くつつく / (特にひじで)軽くつつくこと 
nurse	 『看護人』,看護婦 / 子守(dry nurse) / 『乳母』(うば)(wet nurse) / ‘を'『看護する』,看病する / 〈幼児〉‘に'授乳する / 〈病気・けが〉‘を'治そうと努める / 《話》…‘を'注意して扱う,たいせつに扱う / …‘を'大事に育てる / (心に)〈ある感情〉‘を'いだく / 看護人(看護婦)として働く / 授乳する / 〈幼児が〉乳を飲む
nymph	 『ニンフ』(ギリシア・ローマ神話で泉・川・森・海などに住む美しい妖精) / 美少女 / 若虫(じゃくちゅう)(トンボ・セミなどの不完全変態をする昆虫の幼虫) 
oaken	 オーク材製の 
oakum	 まいはだ(古い麻なわをほぐしたもの;船板のすき間に詰める) 
obeah	 (アフリカ・西インド諸島で行われる)魔術 
ocean	 〈C〉『大洋』,大海 / 《the ~》五大洋の一つ / 《話》《an ~,または複数形で》ばく大(な…),広大(な…)《+『of』+『名』》 
odium	 憎悪,反感 / 汚名,悪評
often	 『しばしば』,たびたび,よく / 何度,何回
oiled	 油を差した(しみ込ませた) / 《俗》酒に酔った(drunk)
okapi	 オカピ(アフリカ産;キリンに似る) 
olden	 昔の 
olive	 〈C〉『オリーブ』[の木](南欧産の常緑樹) / 〈C〉オリーブの実(ピクルスにしたり,オリーブ油を採る) / (また『olive green』)〈U〉オリーブ色,黄録色 / オリーブの;オリーブ色の
omega	 〈C〉オメガ(ギリシア語アルアァベット24文字の最後の字Ω,ω;英語のO,oの長音に相当) / 〈U〉(一連のものの)最後,終り(end)
onset	 攻撃,襲撃 / (病気・季節などの)始まり,開始《+『of』+『名』》
opera	 『オペラ』,歌劇 
opine	 《『opine』+『that節』》…‘と'考える,思う 
opium	 アヘン(阿片)ケシの種子から製造;催眠剤・鎮痛剤として使われる) 
optic	 目の;視覚の 
orate	 演説する,演説口調で話す 
orbit	 (天体・人工衛星の)『軌道』;軌道の1周 / (活動・影響・知識の)範囲 / (軌道に沿って)…‘の'周りを回る / 〈人工衛星〉‘を'軌道に乗せる / 軌道に沿って回る,軌道に乗る 
organ	 『オルガン』,パイプオルガン(pipe organ),リードオルガン(reed organ),電子オルガン(electronic organ),手回しオルガン(barrel organ) / (動植物の)『器官』 / (政党・会社などの)機関誌,機関紙 / 《しばしば複数形で》(行動・実施などの)組織,機関
oriel	 (壁から外に突き出た)張り出し窓,出窓 
osier	 コリヤナギ[の枝](枝はかご細工に用いる) 
other	 《no,one,some,anyなどを伴って》『別の』,ほかの,違った / 《other thanの形で補語に用いて》…とは違った,…とは別の / 《the ~》(二者のうちの)『もう一方の』,他方の;『反対の』,向こう側の;(三者以上のうち)それ以外の,残りの / 『ほかのもの』,ほかの人[たち] / 《the ~》(二つの中で)『もう一方のもの』(『人』り,(三つ以上の中で)『これ以外のもの』(『人』),残りのもの(人) / 《『other』 『than』の形で》(…と)別の方法では,(…)ではなく
ought	 《義務・当然》…『すべきである』,するのが当然である / 《忠告・願望》…するのが望ましい,するのがよい / 《見込み・当然の結果》…『するはずである』,きっと…するであろう 
ounce	 〈C〉『オンス』(重量の単位;《略》『oz.』;常衡で1オンスは1/16ポンド(28.35gr.),金衡で1/12ポンド(31.1gr.)) / 〈C〉液量オンス(1オンスは《米》では1/16パイント(pint),《英》では1/20パイントに等しい) / 《通例否文で》《an ~》少量(の…)《+『of』+『名』》 
ousel	 =ouzel 
outer	 外に,外側の,外部の / 中心から遠い
outre	 (考え方・行動などが)常軌を逸した,奇異な,異常な 
ouzel	 クビワツグミ(全体が黒く胸に白い輪のある鳥) 
ovary	 卵巣 / (花の)子房
ovate	 (特に葉が)卵形の 
overt	 明白な,公然の 
ovule	 胚珠(はいしゅ) 
owing	 (…に)『未払いの』,支払うべき(due)《+『to』+『名』》 
owlet	 フクロウの子 / 小型のフクロウ
owner	 『持ち主』,所有者 
oxide	 酸化物 
pacer	 歩測者 / 側対歩で進む馬
padre	 (イタリア・スペイン・ポルトガル・南米などの)神父(father) / 《話》従軍牧師
paint	 〈U〉『ペンキ』,『塗料』 / 〈U〉〈C〉(油性・水性の)絵の具(チューブ入りおよび水に溶かす前の固型状のもの) / 〈U〉《しばしば軽べつして》(化粧品の)口紅,ほお紅 / …‘を'『絵の具でかく』 / …‘に'ペンキ(塗料)を塗る / …‘を'言葉で描き出す / (薬・化粧品などを)〈傷口・顔など〉‘に'塗る《+『名』+『with』+『名』》 / 〈人が〉ペンキ(塗料)を塗る,絵の具で絵をかく / 〈物が〉よく塗れる,絵の具がよくつく / 《しばしば軽べつして》化粧する
palmy	 ヤシ(シュロ)の多い,繁栄する,勝利を得た,意気揚々とした,椰子の茂った,手のひらへのむち打ち 
palsy	 麻痺(まひ),中風 / …‘を'麻痺させる(paralyze)
panel	 『はめ板』,鏡板,仕切り板,『パネル』(壁・天井・ドアなどを装飾する板) / (板・プラスチックなどの薄い)1枚板,合板 / (絵画の)画板,パネル画;(写真の)パネル版 / (飛行機・自動車などの)パネル,計器板 / (スカート・ドレスなどに縫いつける)別布,パネル / 《集合的に》(討論会などの)討論者団,審査団,参加者の一団 / (…で)…‘に'パネルをはめる,はめ板を張る《+『名』+『with』(『in』)+『名』》 
panic	 〈C〉〈U〉『あわてふためき,恐慌』,ろうばい / 〈C〉経済恐慌,パニック / 《単数形で》《米俗》とてもおかしなもの,珍無類なもの / あわてふためく,恐慌に陥る / …‘を'あわてさせる / 《米俗》〈観客〉‘を'沸きたたせる
pansy	 サンシキスミレ / 《話》女のような男;同性愛の男
panto	 =pantomime 
pants	 《米》『ズボン』(trousers),ジーパン,スラックス / 《おもに》パンツ(underpants);(婦人・小供用の)パンティー
parch	 〈熱・太陽などが〉〈のど・土地など〉‘を'からからに乾かす / 〈豆など〉‘を'いる,あぶる / からからに渇く
parky	 (空気などが)ひんやりとした,冷たい 
parse	 〈文〉‘を'文法的に説明する;〈文〉‘を'構成要素に分折する 
party	 『社交的な集まり』,パーティー / 『一』,一隊,一団 / 『党』,政党 / (ある行動・計画などの)関係者,仲間,(時に)参加団体《+『to』(『in』)+『名』》 / (契約・訴訟などの)当事者,記名人;訴訟当事者(原告または被告のこと) / 《話》人(person)
parve	 (ユダヤ教で)精進料理の(原料に獣肉や乳を用いない) 
paste	 (接着用の)『のり』 / (一般に)のり状のもの / (菓子を作るための)練り粉,ペースト / (人造宝石用材料の)鉛ガラス;模造宝石 / (…に)…‘を'『のりではる』《+『down』+『名』+『in(on)』+『名』》 / (…を)…‘に'のりではり付ける《+『名』+『with』+『名』》 / 《俗》<顔・体など>‘を'強打する,なぐりつける 
pasty	 のりのような / (顔色などが)青白くて不健康な(pale)
patch	 (補修・補強のための)『つぎ当て』;当て布;当て板,当て金;(アップリケで縫いつけた)布切れ / (傷口などを覆う)『傷当て』 / (色などが周囲と区別できる)(…の)まだら,班点;断片,破片《+『of』+『名』》 / 小さな地面(畑) / (補修・補強のために)…‘に'『つぎ当てる』;(装飾のために)…‘に'当て布をする / …‘を'つぎ合わせて作る
paten	 パテナ(聖体祭儀のときパンをのせる金属製の皿) 
pater	 おやじ,父 
patio	 (スペイン風住宅の)中庭 / (戸外の食事や談笑のための)テラス
patsy	 他人の罪を負う人 / お人よし,かも
pause	 『小休止』,中断,休息;(会話,読み書きの間に入れる)一息,一区切り / (音楽の)延音記号,フェルマータ / (一時的に)『ちょっと休止する』,立ち止まる;(…するのを)ちょっとやめる / (…の所で)停滞する,ちゅうちょする《+『of』(『upon』)+『名』》
paved	 (タイル・アスファルトなどで)舗装された / 《補語にのみ用いて》(…で)満ちあふれる《+『with』+『名』》
pawky	 《おもに英》ずるい,悪賢い 
payer	 支払い人 
peach	 〈C〉『モモ』(『桃』) / 〈C〉桃の木 / 〈U〉黄色がかった桃色 / 〈C〉《a ~》《話》すてきなもの;かわいい娘 / 黄色がかった桃色の 
peaky	 峰のようにとがった / 衰えた,やつれた / 《話》気分が悪い 
pearl	 〈C〉『真珠』,パール / 〈C〉(形・光沢などが)真珠のようなもの / 〈C〉(真珠のように)価値のあるもの(人),傑出したもの(人) / =mother=of-pearl / (また『pearl gray』)〈U〉真珠色 / 真珠の[ような] / 真珠色の / 真珠を採取する
peaty	 泥炭を含む,泥炭に似た 
pecan	 ペカン(米国原産のクルミの一種);ペカンの実(食用になる) 
pedal	 (自転車・自動車などの)『ペダル』,踏み板 / (ピアノなどの)ペダル,踏み板 / …‘の'ペダルを踏む;(ペダルを踏んで)…‘を'走らせる / ペダルを踏む;(ペダルを踏んで)動かす / (人・動物の)足の / ペダルの
penal	 (特に,法的な)刑罰の / 刑事上の
penis	 陰茎,ペニス 
perch	 (鳥の)『止まり木』,(枝など)止まり木になるもの / 高い場所;(一般に)高い地位 / 《英》パーチ(長さの単位,約5メートル;面積の単位,25.3平方メートル) / (高い所に)…‘を'置く,のせる《+『名』+『on』+『名』》 / 〈鳥が〉止まり木に止まる / (高い所に)止まる,休む,腰をすえる《+『on』(『upon』)+『名』》
peril	 〈U〉(差し迫った大きな)『危険』,危難,危機 / 〈C〉危険をもたらすもの / …‘を'危険にさらす 
perky	 活発で元気のよい,意気揚々とした
pesky	 やっかいな,うるさい 
petal	 花弁,花びら 
phage	 =bacteriophage 
phase	 (変化・発達の)『段階』,『局面』 / (物事の)『面』,様相《+『of』+『名』》 / (月・惑星などの)相 / …‘を'段階的に調整(整理)する
phial	 =vial 
phlox	 フロックス,クサキョウチクトウ 
phone	 〈U〉〈C〉『電話』;〈C〉『電話機』,受話器 / …‘に'『電話をかける』 / 『電話をかける』 
piano	 『ピアノ』 
picky	 ささいなことにやかましい,気むずかしい 
picot	 ピコット(ししゅう・レース・リボンなどの縁に施す丸い輪飾りの一つ) / …‘に'ピコットで縁飾りする
pieta	 ピエロ(キリストの遺体をひざにだいて嘆く聖母マリアの絵や像) 
piety	 〈U〉敬けんなこと,信心 / 〈U〉(両親・母国・理想などに対する)忠誠,敬愛 / 〈C〉敬けんな行為(信仰) 
pigmy	 =pygmy 
piker	 しみったれ,けち 
pilau	 =pilaf 
piles	 痔疾(じしつ) 
pilot	 『水先案内人』舵手(たしゅ) / (飛行機の)『パイロット』,操縦士 / 案内人,先導者(leader) / =pilot light / 試験的な,実験的な,予備的な / 《方向を表す副詞[句]を伴って》〈船〉‘の'『水先案内をする』 / 〈飛行機〉‘を'操縦する;〈船〉‘の'かじを取る / 《方向を表す副詞[句]を伴って》(|に向けて)〈人〉‘を'案内する,導く
pinch	 (…で)…‘を'『つねる』,『つまむ』《+『名』+『in』+『名』》 / (靴などが)…‘を'『締めつける』 / 《しばしば受動態で》〈悲しみ・苦通などが〉〈人・心・体など〉‘を'苦しめる,悩ます / (木などの形を整えたりするために)〈芽・若枝など〉‘を'摘み取る《+『off』(『back』)+『名,名』+『off』(『back』)》 / 《俗》…‘を'盗む,巻き上げる / 《話》《受動態で》…‘を'逮捕する / 〈靴・帽子などが〉『締めつける』,きつく締まる / (…を)けちけちする《+『on』+『名』》 / (…を)『つねる』(『つまむ』)『こと』《+『on』+『名』》;(靴などが)きつくて痛いこと / (…の)一つまみ,少量《+『of』+『名』》 / 《the pinch》(飢え・金銭上の)苦しみ,難儀 / 危機,危急の時 / 《属》盗み / 《俗》逮捕
piney	 =piny 
pinko	 左翼がかった人 
pinto	 まだらの,ぶちの / まだらの馬(小馬)
pious	 『敬けんな』,信心深い / 宗教的な,宗教上の / 《軽べつして》敬けんを装った,信心ぶった 
pique	 《しばしば受動態で》(…で)〈人〉‘を'憤慨させる,‘の'気持ちを傷つける《+『名』+『at』(『by』)+『名』(a persons do『ing』)》 / 〈人,人の好奇心・野心など〉‘を'そそる,刺激する / (…に対する),立腹,不きげん《+『at』(『against』)+『名』(a persons do『ing』)》 
pitch	 ピッチ(石油・コールタールなどで蒸留後に浅る黒いかす) / 松やに,樹脂 / …‘に'ピッチを塗る 
pithy	 髄の;髄のある / 簡潔で要領を得た
piton	 ピトン(岩登りに用いるロープを通す環のついた金属クギ) 
pivot	 (機械の)旋回軸 / 中心人物;要点,かなめ / 旋回 / (…を軸にして)旋回する;回転する《+『on』(『upon』)+『名』》 / 《『pivot on』(『upon』)+『名』》…によって決まる,…に左右される / …‘を'旋回軸の上に恥く;…‘に'旋回軸をつける
place	 〈C〉『場所』,『位置』;(物の占める)空間 / 〈C〉『地域』,地方,土地 / 〈C〉(特定の目的のための)『場所』,建物 / 〈C〉《話》住居,家 / 〈C〉(体や物などの表面の)箇所,局部 / 〈C〉(書物中の)読んでいる家所 / 〈C〉席,座席 / 〈C〉『地位』,立場,境遇 / 〈C〉『職』,勤め口;(職場・学校などの)席,定員 / 〈C〉任務,役目 / 〈C〉(説明などの)順序,段階 / 〈C〉《米》(競馬などで)第2着 / 《多く固有名詞に用いて,P-》通り,広小路;広場 / 〈C〉(数字の)けた,位(くらい) / 《場所を表す副詞[句]を伴って》…‘を'『置く』,配置する,据える / (職,地位に)〈人〉‘を'つかせる,任ずる,〈人〉‘に'(…の)職を見つけてやる《+『名』+『in』(『as, with』)+『名』》 / (人・物に)〈信頼・希望など〉‘を'置く,かける《+『名』+『on』(『in』)+『名』》 / (店などに)(…の)〈注文〉‘を'出す《+『名』〈注文〉+『for』+『名』〈品物〉+『with』+『名』〈店〉》 / (…だと)…‘を'見きわめる,思い出す《+『名』+『as』+『名』》 / 《順位を示す副詞を伴って》(競争などで)…位(着)になる
plaid	 〈U〉格子じま;格子じまの織物 / 〈C〉(スコットランド高地人の用いる)格子じまの肩掛け / 格子じまの 
plain	 『はっきり見える』(『聞こえる』) / 『はっきり理解できる』,明白な / 全くの(sheer) / 混ぜ物のない,生(き)のままの;飾りのない;無地の / ありのままの / 『質素な』,飾り(模様)のない / (食べ物が)淡白な / 平凡な,並みの,普通の;素朴な / 『平原』,平野;《the Great Plains》(北米の)大平原地帯 
plait	 (また『plat,』《おもに米》『braid』)(髪・麦わらなどの)編んだもの / =pleat / (また『plat,』《おもに米》『braid』)〈髪〉‘を'編む;〈敷き物など〉‘を'編んで作る / =pleat
plane	 『平面』,水平面 / 『水準』,程度 / 《話》『飛行機』 / (面が)平らな,平たんな / 平面の,平面図形の;平面上にある / 〈飛行機〉滑走する
plank	 『厚板』 / 政党綱領項目(箇条) / (船から桟橋にかける)歩み板,タラップ / 〈床など〉‘を'厚板で張る / 《米》〈肉・魚など〉‘を'板にのせてあぶり焼きにして食卓に出す 
plant	 (動物に対して)『植物』,草木・(樹木に対して)『草』,草本(そうほん)( 木部があまり発達せず地上部が一年で枯れる植物)・苗,苗木・生産設備,工場,プラント設備,装置・《俗》(人をおとしいれる)わな,おとり / 〈苗など〉‘を'『植える』,〈種〉‘を'まく・(植物を) ‘に'植える《+『名』+『with』+『名』》 / (…に)〈思想など〉‘を'植えつける《+『名』+『in』+『名』》・《場所の副詞[句]を伴って》(ある場所)…‘を'しっかりと置く(すえる,立てる) / ・〈工場・生産設備など〉‘を'建設する・《俗》〈スパイ〉‘を'送りこむ,〈わな〉‘を'仕掛ける・（嫌疑がかかるように）こっそり置く
plash	 =splash 
plate	 〈C〉(通例各人用の丸い)『平皿』 / 〈C〉(料理の)『1皿』[『分』]《+『of』+『名』》 / 〈C〉料理の1人前 / 〈C〉(教会などの)献金皿 / 〈U〉《集合的に》(スプーン・皿など)金(銀)製の食器類 / 〈C〉(金属・ガラス・プラスチックなどの)平板,板金 / 〈C〉(金属・木などの)標札,ナンバープレート / 〈C〉金属(石,木)版画;(本文と別刷りの)図版 / 〈C〉(印刷方法の)電気版,ステロ版 / 〈C〉(写真の)感光板 / 〈C〉《the~》(野球の)本塁(home plate) / (…を)…‘に'めっきする《+『名』+『with』+『名』》 / (保護のために)…‘を'板金で覆う / (印刷で)…‘を'電気版(ステロ版)にする
platy	 プラティ(メキシコ産の淡水魚) 
plead	 嘆願する,懇願する / (訴訟で)(…を)弁護する《+『for』+『名』》;(…に)抗弁する,申し開きをする《+『against』+『名』》 / …‘を'言い訳(理由)として述べる / (訴訟)…‘を'弁護する,弁論する
pleat	 (布などに付けた)ひだ,プリーツ / …‘に'ひだをつける
plena	 plenumの複数形 
plonk	 =plunk 
pluck	 〈花・果物など〉‘を'『摘む』,もぐ(pick) / (…から)〈羽毛など〉‘を'『むしる』,引き抜く《+『名』+『from』(『off』)+『名』》 / …‘を'羽毛を引き抜く / (指・つめなどで)〈楽器の弦〉‘を'はじく,かき鳴らす / (…を)ぐいと引く,引っ張る《+『at』+『名』》 / 〈C〉ぐいと引くこと / 〈U〉(特に危険や困難に際して見せる)勇気,胆力 / 〈U〉《the~》(動物の)臓物
plumb	 （測量・釣りなどの）おもり,鉛錘,(水深を測る)測鉛 / 垂直の(vertical) / 《話》すっかり / 垂直に(vertically) / 《話》全く / (下げ振り糸で)…‘を'垂直かどうか調べる;…‘を'垂直に調整する《+『up』+『名,』+『名』+『up』》 / 〈…の垂直・深さ〉‘を'おもり(測鉛)で測る;《比喩(ひゆ)的に》…‘を'測り知る / …‘を'垂直にする
plume	 《複数形で》(特に大きくて目立つ装飾用の)『羽毛』羽毛飾り,(帽子などの)前立(まえだて) / 大きな羽毛に似た形の物;水柱,煙など《+『of』+『名』》 / …‘を'羽毛で飾る / (くちばしで)〈羽毛〉‘を'整える
plunk	 〈弦楽器〉‘の'弦をかき鳴らす,‘を'はじく / 《話》…‘を'どすんと投げ出す,ぽんと置く《+『down』+『名』》 / 《話》(…の上に)どすんと落ちる《+『down on』(『into』)+『名』》 / 〈弦楽器が〉ポロンと鳴る / (弦楽器を)ポロンと鳴らすこと;ポロンと鳴る音 / 《米話》ごつんとなぐること / ポロンと;どすんと 
plush	 プラシ天 《 (ビロードの一種で厚いけばがある) / 豪華な,ゼいたくな
poach	 (卵・魚など)‘を'熱湯に落として煮る 
podgy	 =pudgy 
poesy	 =poetry 
poilu	 (第一次大戦中の)フランス兵 
point	 〈C〉(針・鉛筆・剣などの)『とがった先』,(…の)先端《+『of』+『名』》 / 〈C〉岬(みさき) / 〈C〉(小数点・句読点などの)点 / 〈C〉(図形上の)点 / 〈C〉(ある特定の)『地点』(spot),場所(place) / 〈C〉(計器の目盛りなどの)『点』,『度』 / 〈C〉時点,瞬間 / 〈C〉《単数形で》(物語・議論などの)『要点』,核心《+『of』(『in』)+『名』》 / 〈U〉(…の)『目的』,『意義』,ねらっている点《+『of』(『in』)+『名』(do『ing』)》 / 〈C〉(全体の中の)個々の項目,細目(item),細部(detail) / 〈C〉特徴(characteristic),特質(trait) / 〈C〉(競技・学校の成績などの)得点 / 〈C〉ポイント(活字の大きさの単位;約1/72インチの大きさ) / (…に)〈銃・指など〉‘を'『向ける』《+『名』+『at』(『to, toward』)+『名』》 / …‘に'『指し示す』《point+名+to+名…に…をさし示す》 / …‘の'先をとがらせる,‘に'先を付ける / …‘に'点を打つ;…‘に'小数点を付ける;…‘に'句読点を付ける / 〈猟犬が〉〈獲物〉‘を'指し示す / (…を)(指などで)『示す』,指し示す《+『at』(『to, toward』)+『名』(do『ing』)》 / 〈猟犬が〉獲物の位置を示す
poise	 …‘を'つりあいをとって置く,…‘の'平衡を保つ / 《まれ》(すぐに使えるように)…‘を'構える / つりあい(平衡)を保っている / つりあい,平衡 / 平静,落つ着き 
poker	 火かき棒 / 突く人(物)
pokey	 監獄・刑務所 
polar	 『極地の』;南(北)極の / 正反対の
polka	 ポルカ(ボヘミアに起こったダンス;その曲) 
porch	 ポーチ(母屋(おもや)から張り出した玄関,車寄せ,入り口部分) / 《米》ベランダ
porgy	 (地中海・大西洋沿岸産の)タイ,タイの類 
porky	 (人が)丸々とふとった,豚のような 
poser	 難題,難問 / (絵・写真の)モデル / =poseur 
posit	 (論争のために)仮定する,(事実として)断定する 
pouch	 (革製の)小袋(たばこ入れ・さいふなど);郵便袋;(兵隊の)弾薬袋 / (カンガルーなどの)腹袋 / (動物の)ほお袋 / (目の下の)たるみ
poult	 (七面鳥・鶏などの)ひな 
pound	 『ポンド』(一般に商業で用いられる重量の単位;16オンス;約453.6グラム;{略}『1b.』) / ポンド(英国・アイルランドなどの貨幣の単位(pound sterling)およびその紙幣;もと20シリング(=240ペンス);1971年2月以後は100ペンス;{略}￡) / トロイポンド(金・銀の重量単位;373.2グラム) 
power	 〈U〉(名身が生れつき備えている,また物事を遂行できる)『能力』,『力』 / 〈U〉(…に対する)権力,支配権《+『over』+『名』》 / 〈C〉(法・官職などによる)権限 / 《複数形で》(生まれながらの)体力,知力,才能 / 〈C〉権力者,実力者;影響力のある集団;強国・大国〈U〉軍事力;国力 / 〈U〉強さ,力 / 〈C〉《通例複数形で》神;悪魔 / 〈U〉動力;工率,仕事率 / 〈U〉(電気などの)エネルギー,力 / 〈C〉(数学で)累乗 / 〈U〉(レンズの)倍率 / 〈U〉《a~》《話》(…の)多数,多量 / 〈機械〉‘に'動力を供給する 
prank	 (悪意のない)悪ふざけ,戯れ 
prate	 《『prate』 『about』+『名』》(…を)べちゃくちゃしゃべる,くどくどと話をする 
prawn	 《おもに英》テナガエビ,クルマエビ / エビを捕まえる
price	 〈C〉(売買の)『値段』,『価格』 / 〈U〉《しばしばa~》(何かを手に入れるための金銭以外の)『代償』,代価 / 〈C〉(犯人逮捕などの)賞金,ほうび / 〈C〉(競馬などの)賭(か)け率 / 《しばしば受動態で》〈商品〉‘に'(…の)値段をつける《+『名』〈商品〉+『at』+『名』〈金額〉》 / 《話》…‘の'値段を確かめる
prick	 (…で)…‘を'『ちくりと刺す』,突く《+『名』+『with』+『名』》 / 〈人,人の心身〉‘を'『ちくちく痛ませる』,ちくちく苦しめる / 『ちくりと刺すこと』 / 刺してできた傷,突き傷;刺し穴 / 刺すような痛み;(心の)うずき,痛み《+『of』+『名』》 / とげ,針
pricy	 =pricey 
pride	 〈U〉『自尊心』,自尊 / 〈U〉『得意』,自慢,誇り / 〈U〉『高慢』,『うぬぼれ』,思い上がり / 〈C〉《単数形で》(…の)『自慢の種』,誇りにする物《+『of』+『名』》 / 〈C〉(特にライオン・クジャクの)群れ《+『of』+『名』》 / 《『pride』『oneself』『on』(『upon』)+『名』(do『ing』)》…‘を'自慢する
prime	 (重要さ・価値などにおいて)『首位の』,『主要な』 / 『最上等の』,最高品質の / (数が)素数の;公約数のない / 〈U〉《the ~》(…の)『全盛期』・最盛期・青春・盛り《+『of』+『名』》 / 〈U〉《the ~》《文》(…の)初期,初め《+『of』+『名』》 / =prime number / 〈旧式の火器〉‘に'火薬を詰める / 〈ポンプ〉‘に'呼び水をする / 〈キャブレター〉‘に'燃料を入れる / 〈画面・壁など〉‘に'下塗りする / (…を)〈人〉‘に'前もって教え込む《+『名』〈人〉+『with』+『名』》 / 《話》(飲食物を)〈人〉‘に'詰め込む《+『名』〈人〉+『with』+『名』》
prink	 =primp 
print	 …‘を'『印刷する』 / 〈原稿・本など〉‘を'『出版する』 / …‘を'『活字体で書く』 / 〈写真〉‘を'『焼きつける』,〈印画〉‘を'つくる / (…に)…‘を'押してつける;(心に)…‘を'刻みつける,印象づける《+『名』+『on』+『名』》 / (印刷・焼きつけなどによって)〈活字・模様・写真などが〉現れる,写る;〈紙などが〉印刷できる / 〈機械が〉印刷する / 活字体で書く / 〈U〉『印刷』,印刷の字体 / 〈C〉《しばしば複合語で》(押した)跡,しるし / 〈U〉プリント模様;プリント生地;〈C〉プリント地の衣服 / 〈C〉(写真の)印画,陽画(positive) / 〈C〉版画 
prism	 プリズム(分光に用いる透明な三角柱) / (幾何で)角柱
privy	 (…の)内情に通じた《+『to』+『名』》 / 屋外便所
prize	 『賞』,賞品,賞金,ほうび / (努力して手に入れる)『価値あるもの』,貴重なもの / 入賞した / 賞品の / 《話》《しばしば皮肉に》賞に値する / …‘を'高く評価する,重んずる
probe	 (傷の深さを調べる)さぐり針 / (…を)厳密に調べること,精査《+『into』(『for』,『at』)+『名』》 / (また『space probe』)(ロケットの)宇宙探測機 / …‘を'厳密に調べる / 〈傷〉‘を'さぐり針で調べる / (…を)厳密に調べる《+『into』(『for』,『at』)+『名』》
proem	 序文,緒言 
prone	 《補語にのみ用いて》傾向がある / うつぶせの,平伏した
prong	 (フォーク・くまでの)また;(雄ジカの)枝角(えだづの) / …‘を'フォーク(角など)で刺す(突く);〈土・干し草〉‘を'くまででかく
prose	 『散文』,散文体 / 散文の
prosy	 (話・文章などが)だらだらした,退屈な / 散文[体]の,散文的な
proud	 (人が)『得意な,誇らしげな』 / (人が)『誇りを持った』,自尊心のある / (人が)高慢な,威張った / 《名詞の前にのみ用いて》(物事が)誇るに足る,みごとな
prove	 …‘を'『証明する』 / …‘を'『試す』,検討する / 《『prove』[『to be』]+『名』(『形』)》(…と)『証明される』,わかる・「で」あると判明する 
prowl	 《副詞[句]を伴って》(獣がえさを求めて,または人が盗みをしようと)足音をしのばせてうろつき回る / 〈場所〉‘を'うろつく / 《単数形で》うろつくこと,さまよい歩き 
proxy	 〈U〉(…の)代理,代理権;〈C〉代理人《+『for』+『名』》 / 〈C〉委任状
prude	 (言動・服装などで)お上品ぶった人,すまし屋 
prune	 (草木から)…‘を'切り取る / 〈草木〉‘を'刈り込む / (不要なものを)…‘から'除く 
psalm	 『賛美歌』,聖歌(hymn) / 《P-》(特に旧約聖書「詩篇」の中の)一編の聖歌
pshaw	 《まれ》ふん,へん,ちぇっ(軽べつ・いらいら・嫌悪(けんお)を表わす) 
psych	 …‘を'心理的にまいらせる,げんなりさせる《+『out』+『名』,+『名』+『out』》 
pubes	 陰毛 
pubic	 恥丘の,恥骨の 
pubis	 恥骨 
pudgy	 小さくてずんぐりした 
pulse	 《通例単数形で》『脈はく』 / (一般に,規則的な)鼓動,律動 / (電気の)パルス / (一般的な)傾向 / 脈を打つ,鼓動する 
punch	 …‘を'『げんこつでなぐる』 / (機械などを動かすために)…‘を'押す / 《話》〈家畜〉‘を'追う・げんこつでなぐる / 〈C〉『げんこつの一打ち』 / 〈U〉《話》迫力 
purge	 (…を除いて)…‘を'『清める』,きれいにする《+『名』+『of』+『名』》;(…から)…を除いて清める《+『名』+『from』+『名』》 / (…を除いて)〈政党など〉‘を'粛清する《+『名』+『of』+『名』》;(…から)〈異分子〉‘を'追放する《+『名』+『from』+『名』》 / 〈腹〉‘に'下剤をかける / 清めること / (異分子の)粛清,追放,パージ / 下剤
purse	 《米》(婦人用)『ハンドバッグ』 / 『さいふ』 / 《単数形で》資金,資力,財力 / 〈C〉賞金,寄付金 / 〈くちびるなど〉‘を'すぼめる,〈まゆ〉‘を'ひそめる《+『up』+『名,』+『名』+『up』》 
pushy	 でしゃばりの,ずうずうしい,押しの強い 
pylon	 (古代エジプトの寺院の)塔門 / (飛行機操縦上の)目標塔(特にレースで用いる) / (高圧線用の)鉄塔 
quack	 ガアガア(アヒルの鳴き声) / 〈アヒルが〉ガアガア鳴く
quail	 ウズラ(キジ科の小鳥) 
quake	 (衝突・地震などで)〈物が〉揺れる,震動する(shake) / (寒気・憎しみ・恐怖などで)〈人が〉震える,身震いする / 揺れ,震動 / 地震(earthquake)
qualm	 (…についての)突然の不安(疑惑)《+『about』+『名』(do『ing』)》 / 《しばしば複数形で》(…についての)良心のかしゃく《+『about』+『名』(do『ing』)》 / (一時的な)めまい,吐きけ 
quark	 クォーク(あらゆる物質の基礎をなす3種の素粒子の一つ) 
quart	 クォート(液量の単位で《米》約0.95リットル,《英》約1.13リットル;乾量の単位で《米》約1.1リットル,《英》約1.13リットル;《略》『qt.』,複数形は『qts.』) / 1クォート容器(ます・びん・つぼなど)
quash	 〈判決・決議など〉‘を'取り消す,破棄する / 〈反乱など〉‘を'鎮める,抑える
quasi	 「(実質的には違うが)見たとこでは」「いくぶんか;ほとんど」の意を表す / 類以の,疑以の;ある意味の,準…
quean	 売春婦,あばずれ 
query	 質問,疑問・疑問符(?)・(不審・疑問を感じて)〈人〉‘に'質問する,〈人の気持ちなど〉‘を'問いただす・〈物事〉‘に'疑問をいだく,‘を'不審に思う・（コンピュータ）質問, 問い合わせ (特定の情報の検索をデータベースに要求すること)
quest	 (…の)探求,探索(search)《+『of』(『for』)+『名』》 / (中世騎士の)冒険の旅;(…を捜し求めての)遠征《+『of』+『名』》 / (…を)探索する《+『for』+『名』》 
quick	 (動作などが)『速い』,急速な,素早い;(人が)敏しょうな,機敏な / (進行・経過などが)『瞬間の』,短時間内の,すぐ終わる / (人,人の頭が)『理解の早い』,りこうな,利発な;(感覚などが)鋭敏な,鋭い / せっかちな,気の短い / 《古》命のある,生きている(living) / (爪の下・傷口などの)最も敏感なところ;(感情の)いちばん痛いところ / 素早く,急いで / 《複合語を作って》「早く(…する)」の意を表す
quiet	 『静かな』,ひっそりした,閑静な / 『音を出さない』(『立てない』),沈黙した(silent) / 『動きのない』,静止した / 『平穏な』,穏やかな,安らかな / (色などが)落ち着いた,じみな / 静かさ,静寂・平穏(tranquility);安静(rest)・平静・〈人・騒ぎなど〉‘を'静める;…‘を'なだめる・静まる;落ち着く
quilt	 キルト(鳥の綿毛を入れて刺し子に縫った掛けぶとん) / …‘を'刺し子に縫う / キルトを作る 
quint	 =quintuple　5倍　5倍の量　5倍の　5重の　5つの部分から成る 
quire	 (紙の)1帖(じょう)(24または25枚) 
quirk	 変な癖,奇癖 / (…の)予期しない急転回,急変《+『of』+『名』》
quirt	 編み皮の乗馬むち 
quite	 『全く』,完全に / 『かなり』,相当に,ずいぶん / ほんとうに,実際に,真に 
quits	 )…と)貸し借りなしで,(…と)対等で《+『with』+『名』》 
quoin	 (建物の外壁の)かど;(そのかどを造る)すみ石 / くさび石 / くさび;くさび型の物 
quoit	 《複数形で》《単数扱い》鉄輪投げ / {C}(鉄輪投げの)鉄輪　尻の穴
quota	 (生産・分配などの個個への)割当・分け前; 割当て（額）・移民割当人数 
quote	 (…から)〈言葉・文章など〉‘を'『引用する』(cite)《+『名』+『from』+『名』》 / …‘を'引き合いに出す / 〈値段・評価額〉‘を'見積もる / …‘を'引用符で囲む / (…から)引用する《+『from』+『名』》 / (…の)相場(時価)を見積もる《+『for』+『名』》 / 見積もり、見積価格、価格を提示されたもの/ =quotation2 / 《複数形で》=quotation mark
quoth	 …‘と'言った 
rabid	 《名詞の前にのみ用いて》(意見・行動などが)過激な,狂信的な(fanatical) / 《名詞の前にのみ用いて》激しい,すさまじい / 狂犬(恐水)病にかかった 
radio	 『ラジオ』[『放送』] / 〈C〉『ラジオ』[『受信機』] / 〈U〉無線電信;〈C〉無線による通信 / 『ラジオの』;無電(無線)の / 〈通信〉‘を'『無電』(『無線』)『で送る』;〈人・船など〉‘に'無電を打つ / 無電を打つ
radon	 ラドン(放射性元素;化学記号はRn) 
rainy	 『雨の』,雨降りの;雨の多い / 雨にぬれた;雨模様の
raise	 …‘を'『上げる』,持ち上げる;〈倒れた物〉‘を'起こす / …‘の'量(程度,価値など)『を上げる』 / 〈地位,名声〉‘を'『高める』;(…の地位などに)…‘を'上げる,高くする《+『名』+『to』+『名』》 / …‘を'生じさせる / …‘を'集める,調達する / 《米》…‘を'育てる,栽培する,飼う / 《おもに米》〈子供・家族〉‘を'扶養する,養育する / 〈建物・像など〉‘を'建てる / 〈気持ち・人など〉‘を'奮い立たせる / 〈疑問・異議・要求など〉‘を'提起する,持ち出す / 〈禁止・封鎖など〉‘を'解く / 〈死者〉‘を'生き返らせる / 〈パン〉‘を'ふくらませる / 『賃上げ』,『昇給』;昇給額(《英》rise)
ramie	 〈C〉カラムシ(アジア産の低木で織物用の繊維が採れる) / 〈U〉カラムシの繊維
ranch	 (米国西部・カナダの)大牧場 / 《米》農場,飼育場 / 牧場を経営する;牧場で働く 
randy	 みだらな,好色な 
range	 〈U〉《時にa~》(価格・気温などの変動の)『幅』 / 〈U〉《時にa~》(知覚・知識などの)『範囲』,広がり / 〈U〉《時にa~》(銃砲・ミサイルなどの)着弾距離,射程 / 〈U〉《時a~》(航空機・船舶などの)航続距離 / 〈C〉(銃砲の)射撃場,(ミサイルなどの)試射場 / 〈C〉《米》放牧地域 / 〈C〉(山などの)列,連なり / 〈C〉(料理用の)レンジ / 〈U〉《しばしばa~》(動植物の)生息(分布)区域 / 《副詞句を伴って》(価格・気温などがある範囲内で)『変動する』,動く / (…を)さまよう,歩き回る,(…に)及ぶ《+『over』(『through』)+『名』》 / 一列(一直線)に延びている / (動植物が)分布している / 《副詞[句]を伴って》(ある状態に)…‘を'『並べて置く』,配列する,整列させる / …‘を'さまよう,歩き回る(受動態にできない) / 《米》〈家畜〉‘を'放牧地に入れる
rangy	 (人・動物が)やせて足の長い 
rapid	 『速い』,『すばやい』,敏速な / (坂などが)急な,険しい / 急流,早瀬 
raspy	 こするような,耳ざわりな / 短気の
ratio	 『比』,比率,『割合』;『比例』 
ravel	 〈編み物・ロープなど〉‘を'解く,ほどく(unravel)《+『out』+『名』,+『名』+『out』》 / …‘を'もつれさせる,からませる;…‘を'混乱させる / 解ける,ほどける / (編み物などから)ほどけた糸の端;ほどけた部分
raven	 ワタリガラス,大ガラス(普通のカラス(crow)よりも大型で,不吉な鳥とされる) / 漆黒(しっこく)の
rayon	 人絹,レーヨン 
reach	 《時間などの副詞[句]を伴って》〈場所・目的地〉‘に'『着く』,『到着する』;〈人,人の耳など〉‘に'『届く』 / 〈ある年齢・状態など〉‘に'『達する』,到達する / 〈手など〉‘を'『差し出す』,『伸ばす』《+『out』+『名』,+『名』+『out』》 / 〈物〉‘を'『手を伸ばして取る』,‘に'手を届かせる / (電話などで)…‘と'連絡する / 〈ある数量〉に達する~届く,及ぶ / 〈人の心〉を動かす / (…に)『手を伸ばす』《+『out to』(『toward』)+『名』》 / (物を)取ろうと手を伸ばす《+『for』+『名』》;(名声などを)手に入れようとする《+『for(after)』+『名』》 / 〈物事が〉(空間的・時間的に)(…)届く,達する《+『to』+『名』》 / 〈U〉《時にa~》(…に)『手を伸ばすこと』《+『for』+『名』》 / 〈U〉(手・声などの)届く範囲《+『fo』+『名』》 / 〈U〉(力・理解などの)及ぶ範囲 / 〈C〉(川の曲がり目の間の)直線流域
react	 (刺激などに)『反応する』《+『to』+『名』》 / (…に)反対する,反抗する《+『against』+『名』》 / (…に)影響を与える;(作用するものに)反作用する,はね返る《+『on(upon)』+『名』》 / (…と)化学反応を起こす《+『with』+『名』》
ready	 『準備ができた』,仕上がった / 《補語にのみ用いて》(進んで喜んで)覚悟している / 《補語にのみ用いて》《『be ready to』 do》『今にも…しようとする』,しがちである / す早い,即座の / すぐに使える;手近の / (…に対して)…‘を'『準備する』,用意する《+『名』+『for』+『名』》 / (銃の)構えの姿勢 / 位置について
realm	 《文》王国(おもに法律・詩・修辞用語) / 《しばしば複数形で》(学問などの)『分野』,領域
rebus	 判じ絵(語句を絵や記号で表したもの;眼(eye)の絵かIを示したりする) 
rebut	 〈非難・証拠など〉‘を'反論する,反ばくする 
recap	 〈古タイヤ〉‘を'補修し再生する(retread) / 再生タイヤ
recip	 reciprocal / reciprocity
recto	 (印刷で)右[側の]ページ 
refit	 〈特に,船〉‘を'修復する,再装備する / 〈特に,船が〉修復される,再装備される / (…の)修復,再装備《+『of』+『名』》 
regal	 王の,帝王の(royal) / 王者らしい(kingly);堂堂とした,荘厳な
reify	 〈推象観念など〉‘を'具体化する,具象化する 
reign	 〈U〉(君主などによる)『統治』,『支配』 / 〈C〉統治期間,治世,御代(みと) / 〈人が〉(…を)『統治する』,支配する,(…に)君臨する《+『over』+『名』》 / 〈物事が〉勢力をふるう,行き渡る(prevail)
relax	 〈緊張・力など〉‘を'『ゆるめる』,和らける(loosen) / 〈規則など〉‘を'緩和する / 〈人〉‘を'楽にさせる,くつろがせる / 〈緊張・力などが〉『ゆるむ』,和らぐ;〈規則などが〉緩和される / 〈人が〉楽にする,くつろぐ,緊張をほぐす 
relay	 (駅馬車などの)替え馬,継ぎ馬 / (仕事の)交代,交代班 / 《話》=relay race / (放送の)中継;(電気の)継電器 / (…へ)〈伝言・放送など〉‘を'中継する,中継して伝える《+『名』+『to』+『名』》 
relic	 遺物,遺跡 / (昔の)なごり,形見,記念品 / (聖人の)遺骨,聖骨,聖遺物 
remit	 〈金〉‘を'送る / 〈罰金など〉‘を'免除する,取り消す(cancel) / 〈罪〉‘を'許す / …‘を'ゆるめる,減ずる / (権威ある人などに)〈決定など〉‘を'持ちこむ,任せる《+『名』+『to』+『名』〈人〉》 / 送金する / 弱まる,和らぐ 
renal	 腎臓の 
repay	 …‘を'『返す』 / (…に対して),〈人〉‘に'『報いる』《+『名』〈人〉+『for』+『名』(doing)》 / 〈行為〉‘に'お返しをする,答える 
reply	 (…に)『答える』,返事する《+『to』+『名』》 / (…に)『応じる』,応戦する《+『to』+『名』》 / 《reply to+名+that節》(…に)…‘と'『答える』 / (…に対する)答え,回答(answer)《+『to』+『名』》
repot	 〈植山〉‘を'他の植木鉢に植えかえる 
resin	 樹脂,松やに(ワニスや薬品の製造に使う) 
retch	 むりやりに吐き出そうとする 
rheum	 《米》粘膜分泌物(涙・鼻汁など) / 《古》鼻カタル,感冒
rhino	 =rhinoceros 
rhyme	 〈U〉『韻』(いん),押韻,脚韻 / 〈C〉(…の)同韻語《+『for』+『名』》 / 〈C〉詩,韻文 / (進行形にできない)(…と)韻を踏む《+『with』+『名』》 / (韻を踏んだ)詩を作る / (進行形にできない)…‘を'韻を踏ませる / 《文》《古》…‘を'韻文で書く 
ridge	 『山の背』,尾根 / (動物の)背,背すじ;(畑などの)うね,あぜ / (一般に,うねのような)隆起 / 〈屋根〉‘に'むねをつける;〈畑など〉‘に'うねをたてる
rifle	 『ライフル銃』,小銃 / 《the rifles》ライフル銃隊 / 〈銃身〉に施条をつける 
right	 《名試の前にのみ用いて》『右の』,右側の / 《しばしば『R-』》(政治上)『右派の』,保守的な / 〈U〉《the~》『右』,右側,右方 / 〈C〉『右手』(right hand) / 〈U〉《集合的に》《しばしばthe R-》(政治上の)右派,保守派 / 〈C〉(野球の)右翼(right field) / 『右に』,右側に,右方に 
rinse	 …‘を'すすぎ(ゆすぎ)洗いする《+『out』+『名,』+『名』+『out』+》 / (…から)…‘を'すすぎ(ゆすぎ)落とす《+『off』(『out, away』)+『名』+『out of』+『名』》 / すすぐ(ゆすぐ)こと,すすぎ(ゆすぎ)洗い / すすぎ(ゆすぎ)水;(髪の)リンス液
ripen	 〈果物・時機などが〉『熟する』,〈人などが〉成熟する / …‘を'『熟させる』,成熟させる
risen	 riseの過去分詞 / 上がった,昇った / 復活した 
risky	 危険な,危ない / =risque
ritzy	 いきな,しゃれた 
rival	 (…の)『競争相手』,『ライバル』,好敵手,匹敵する人(物)《+『for』+『名』》,(…における)競争相手《+『in』+『名』》 / 競争する,対坑する / (…において)…‘と'『競争する』《+『名』+『in』+『名』(do『ing』)》 / 《おもに米》(…において)…‘に'『匹敵する』,‘と'肩を並べる《+『名』+『in』+『名』(do『ing』)》
rivet	 リベット(重ねた金属板に差し込みその頭部をたたきつぶして固定するびょう) / (…に)…‘を'リベットで留める《+『名』+『down』(『together』)+『on』(『upon,to,into』)+『名』》 / (…に)〈注意・視線など〉‘を'くぎ付けにする《+『名』+『on』(『upon, to』)+『名』》 
riyal	 リアル(サウジアラビア及びイエーメンアラブ共和国の通貨の単位) 
roach	 コイ科の淡水魚(欧州産) 
roast	 (オーブンまたは直接火で)〈肉など〉‘を'『焼く』,あぶる,蒸し焼きにする / …‘を'『炒』>い)『る』,焙(ほう)じる / …‘を'暖める,熱くする / 《話》〈人〉‘を'こっぴどく叱る,‘に'お灸(おきゅう)をすえる;…‘を'こきおろす / 『笑ける』,笑かれる,あぶられる / 炒られる,焙じられる / 《通例進行形で》焼けるように暑(熱)い / 〈U〉〈C〉(大きな塊の)焼肉;焼肉用の肉 / 〈C〉《おもに米語》野外の焼肉パーティー / 焼いた,あぶった;炒った
robin	 (またrobin redbreast)(ヨーロッパの)『ロビン』,『コマドリ』(胸が黄色がかって赤色;声がよくておとなしく,英国民に古くから愛されて数々の詩に歌われている小鳥で,英国の国鳥;キリストにまつわる伝説により神聖視されることも多い;アメリカのrobinはこれより大型の渡り鳥である) / (アメリカなどの)コマツグミ,ワタリツグミ(胸と腹がクリ色がかった赤色)
rocky	 岩の多い;岩から成る / 岩のような,硬い / (意志などが)堅い,確固たる 
rogue	 『悪党』(vagrant),いんちき野郎(scoundrel) / いたずらなひょうきん者,(特に)いたずらっ子 / 群れを離れた危険な野生動物(特に象) 
roman	 ローマ字体,ローマン活字体 / ローマ字体の
rosin	 ロジン(バイオリンなどの弦にこすりつける固型の松やに) / 〈バイオリンの弓など〉‘に'ロジンを塗る
rouge	 口紅,ほお紅 / べんがら(金属・ガラスなどの研摩剤) / 〈くちびる・ほお〉‘に'紅をつける 
rough	 (表面が)『粗い』,ざらざらした,きめの粗い・でこぼこの / (動きなどが)『荒っぽい』;(空・海などが)荒れた / (人・態度などが)『粗野な』,荒々しい,無作法な / 『おおよその』,あらましの / (ダイヤモンドなど)自然のままの,未加工の / 《話》困難な,つらい,ひどい;(…に)ひどい,むごい《+『on』+『名』》 / (生活が)非文化的な,不便な / 毛深い,毛むくじゃらの,毛が刈ってない / …‘を'乱暴(手荒)に扱う《+『up』+『名,』+『名』+『up』》 / 〈計画・作品など〉‘の'概略を書く,‘を'ざっと下書きする《+『in』(『out』)+『名,』+『名』+『in』(『out』)》 / 〈物の表面など〉‘を'ざらざらにする / 手荒く,乱暴に / 〈U〉《the rough》ラフ(ゴルフのコースで芝をはったフェアウェイ以外の部分) / 〈C〉乱暴者
round	 …『を[ぐるっと]回って』,を一周して / …『を曲がって』 / …『の周囲に』,を取り巻いて / …『のあちこちに』,の辺りに / …『ころ』 / (ぐるりと)回って,巡って / 周囲が(に) / あちこち[に],方々[に];行き渡って / 回り道して / (ある場所へ)回って / 『球状の』,丸い / (タイヤ・輪のように)円形の,丸い / (断面の丸い)円筒(円錐)形の / (肩・筆跡などが)丸みのある,丸々とした / 《名詞の前にのみ用いて》(数量が)完全の,ちょうどの / 『丸い物』;円,輪;球,円筒形 / (中心・軸をまわる)『回転』,(天体の)回転運動 / 《しばしば複数形で》(職務上などの)巡回,見回り / 《単数形で》(行い・でき事の一つの)連続;繰り返り;(…が)ひとしきり続くこと《+『of』+『名』》 / (ボクシングの一勝負の中の)『ラウンド』,回,(ゴルフデ全部のホールを回る)ラウンド,(カードゲームの)一回り / 輪唱 / (銃砲の)1回の射撃,一斉射撃 / (射撃用弾薬の)1回分 / (牛のもも肉の)丸切り,(パンの)丸切り《+『of』+『名』》 / 輪舞,円舞 / …‘を'『丸くする』,‘に'丸みをつける / …‘を'『回る』,曲がる / 〈端数をもつ数字〉‘を'端数を切り捨てて(概数で)表す《+『down』+『名』+『to』+『名』》 / …‘を'完成する,仕上げる / …‘を'くちびるを丸くして発音する / 『丸くなる』 / 回る,曲る / 完成する 
rouse	 (眠り・無意所などから)〈人〉‘の'『目を覚まさせる』,‘を'起こす《+『名』〈人〉+『from』(『out of』)+『名』》 / 〈人〉‘を'『奮起させる』,刺激する / 〈感情など〉‘を'刺激する,かき立てる / 《英ではまれ》〈人が〉目を覚ます《+『up』》 / 〈人が〉奮起する,〈感情が〉激する《+『up』》 
route	 『道筋』,路線,ルート / 《米》(南商人・配達人などの)巡回路;巡回区域 / …‘を'道筋を決める / …‘を'(…の)ルートで送る《+『名』+『by』(『through』)+『名』》
rowan	 ナナカマド(mountain ash)(バラ科の落葉高木) 
rowdy	 (人・行動が)乱暴な,騒々しい / 乱暴者,騒々しい人
rowel	 花車(拍車(spur)の端の小歯車)・（拍車の）歯輪（を当てる）・《獣医》串線打膿条 
royal	 《しばしばR-》『王の』,女王の,王室の / 王(女王)に属する,王(女王)に仕える / 王(女王)から与えられる / 王(女王)にふさわしい,威厳のある,壮麗な,堂々たる
runty	 (同種の中で)普通より小さい,発育不良の,ちびの 
rushy	 灯心草の多い / 灯心草でできている
rusty	 さびた / さび色の / (使用しないために)だめになった 
sable	 〈C〉クロテン(北ヨーロッパ・アジア産);〈U〉その毛皮 / 〈U〉黒 / 《しばしば複数形で》喪服 / (紋章で)黒色の / 《詩》黒い,暗黒の 
sabot	 サボ(フランス・オランダなどで農夫などがはいた木靴,または木底靴) 
sabre	 =saber 
sadhu	 (ヒンズー教の)聖者 
sadly	 『悲しそうに』 / ひどく
saint	 《しばしばs-》『聖人』,聖者(死後カトリック教会や他の教会また特定の宗教によって聖徒に列せられ,尊敬される人);《聖者の名の前に置いて》聖…(《略》St.) / (無私,無欲,有徳の)聖人のような人
saith	 sayの三人称単数現在形 
salon	 (上流家庭の)客間,大広間 / (昔のフランスで,上流貴婦人の開いた)招待会;社交界 / 美術品展示場(室),画廊 / 《米》(美容・服飾などの)店
salty	 塩のきいた,塩辛い / 《話》海の,船乗りの;海上生活の / ぴりっとしたところのある,辛らつな 
salve	 軟こう / 《文》慰め / …‘に'軟こうをはる / 《文》〈悔恨・苦しみなど〉‘を'静める,和らげる
salvo	 (攻撃,時に礼砲の)一斉(いっせい)射撃;一斉爆撃 / 一斉に起こる拍手かっさい
sandy	 『砂の』;砂だらけの / 砂色の,薄茶色の(yellowish brown)
sarge	 =sergeant 
sarky	 =sarcastic 
satin	 しゅす,サテン / =satiny
satyr	 サチュロス(ギリシア神話で半人半獣の酒色を好んだ森の神;ローマ神話のfaunにあたる) 
sauce	 〈U〉〈C〉『ソース』 / 〈U〉果物の砂糖煮 / 《話》=sass / …‘を'ソースで味つけする;…‘に'ソースをかける / 《話》=sass 
saucy	 生意気な,ずうずうしい / 《話》気のきいた,いきな
saute	 (強火で)…‘を'さっと揚げる / 軽く揚げた / (軽く揚げた)ソテー料理 
savoy	 チリメンタマナ(キャベツの一変種) 
scald	 〈熱湯・湯気(ゆげ)が〉…‘を'やげどさせる / ‘を'煮沸[消毒]する / 〈ミルクなど〉‘を'沸点近くまで煮たたせる(熱する) / (熱湯・湯気での)やけど
scale	 《しばしば複数形で》『てんびん』,はかり / てんびんのさら / 《重量を表す副詞[句]を伴って》…の目方(体重)がある / …‘を'てんびんではかる
scalp	 頭皮(髪でおおわれている部分) / 頭髪つきの頭皮(昔北米インディアンが戦利品として敵の頭からはいだもの) / 《話》(一般に)戦利品 / …‘から'頭皮をはぎ取る / 《米話》〈入場券など〉‘を'高値で転売する 
scaly	 うろこにおおわれた;うろこでできた / うろこ状の / ぼろぼろにはげ落ちる(flaking) 
scamp	 ならず者 / いたずら者,わんぱく小訴
scant	 乏しい,不足ぎみの / 《米》《数詞を伴って》(その数に)わずか足りないだけの,…足らずの / …‘を'出し惜しむ 
scare	 …‘を'『おびえさせる』,こわがらせる(frighten) / 『おびえる』,驚く / 《単数形で》おびえ,どきりとすること / (社会的な)恐慌[状態]
scarf	 『スカーフ』,えり巻き / 《米》掛け布;テーブル掛け,ピアノ掛けなど
scarp	 急傾斜,急坂 
scary	 恐ろしい,こわい / こわがりの,おくびょうな
scent	 〈U〉〈C〉『におい』(smell),かおり,香気 / 〈C〉《単数形で》(動物・人が残す)『臭跡』 / 〈C〉《単数形で》(人・物を見つけ出す)経路,方法,手がかり / 〈U〉《しばしばA~》嗅覚 / 〈U〉《おもに英》香水 / 〈猟犬などが〉…‘を'かぎつける《+『out』+『名,』+『名』+『out』》 / 〈人が〉…‘を'かぎつける,感づく;〈…だ〉‘と'感づく《+『that節』》 / 《通例受動態で》…‘に'香水をつける;(香水などで)…‘を'におわせる,よいかおりにする《+『with』+『名』》
schmo	 うすのろ,まぬけ　馬鹿 
schwa	 あいまい母音,シュワー(…で示される弱母音) / あいまい母音の発音記号
scion	 (またcion)(つぎ木の)若枝,つぎ穂(shoot) / 子孫
scold	 〈人〉‘を'『しかる』,‘に'小言を言う / しかる;(…に向かって)ののしる《+『at』+『名』(do『ing』)》 / 口やかましい人;がみがみ女 
scone	 (丸い)小型パン,菓子パン(《米》biscuit) 
scope	 (物事の及ぶ)『範囲』 / (人の理解・行動する)『能力の限界』,視野 / (表現・発達・活動する)機会,余地《+『for』+『名』》 
score	 (ゲーム・競技の)『スコア』,得点記録 / (ゲーム・競技の)『得点』 / (試験の)点数,評点 / 《おもに文》20[の単位] / 《複数形で》多数(の…)《+『of』+『名』》 / 《まれ》勘定,借金 / 《単数形で》理由,根拠,原因 / (また『score mark』)刻み目,線,印 / 総譜,楽譜 / (ゲーム・競技で)〈点数〉‘を'『得点する』 / 〈競技〉‘の'得点を記録する / 〈得点〉‘を'〈人〉‘に'与える《+『名』〈人〉+『名』〈得点〉=+『名』〈得点〉+『to』(『for』)+『名』〈人〉》 / 〈試験〉‘を'採点する;(試験で)…‘の'点をとる《+『名』+『on』+『名』》 / (…で)…‘に'刻み目(印)をつける,線をひく《+『名』+『with』+『名』》 / 《米話》…‘を'こきおろす,酷評する / 《通例受動態で》(…のために)〈音楽〉‘を'作曲(編曲)する《+『for』+『名』》 / (ゲーム・競技で)『得点する』 / 優勢となる,成功する / 《俗》〈男が〉(女を)くどき落とす《+『with』+『名』》 / 《俗》麻薬を売う
scorn	 〈U〉(…の,…に対する)『軽べつ』,さげすみ《+『of』(『for』)+『名』》 / 〈C〉(…の)軽べつの的,物笑いの種《+『of』(『to』)+『名』》 / …‘を'『軽べつする』,さげすむ / (軽べつして)…‘を'『はねつける』
scour	 (きれいにするために)…‘を'こする,磨く / (…の)〈汚れなど〉‘を'こすって洗い流す《+『of』+『名』》;(…の)〈汚れなど〉‘を'こすって落とす《+『名』+『off』+『名』》 / 〈水流が〉〈水路〉‘を'作る / こする,磨く / こすること,磨き洗い 
scout	 『斥候』(せっこう),偵察(ていさつ)機,偵察艦 / (また 『talent scout』)(スポーツ・芸能関係などの新人を捜す)スカウト / 《おもに米》ボーイ(ガール)スカウト / 『偵察する』 / (…を)『捜す』,捜し求める《+『for』+『名』》 / …‘を'偵察する / …‘を'偵察して突き止める《+『out』+『名,』+『名』+『out』》 
scowl	 顔をしかめる,怒った(不きげんな)顔をする;(…を)にらむ《+『at』(『on』)+『名』》 / …‘を'顔をしかめて表す(言う) / しかめっつら,仏頂づら 
scrag	 〈C〉やせこせた人(動物) / 〈U〉ヒツジの首肉 / …‘の'首を絞める,‘を'絞殺する 
scram	 逃げる,すぐに出て行く 
scrap	 〈C〉『かけら』,小片;少し;《A~》少々(の…)《+『of』+『名』》 / 〈C〉《複数形で》残りもの,食べ残し / 〈U〉(くず鉄など)金属のスクラップ / 〈U〉『くず』,廃物,がらくた / (役に立たないとして)…‘を'捨てる(discard) / …‘を'くず(スクラップ)にする
screw	 『ねじ』ねじくぎ,ねじボルト / ねじ(らせん)状のもの / (ねじの)ひとひねり,ひと回し / (またscrew propeller)(船などの)スクリュー / 《英俗》看守 / 《英俗》給料 / 《英俗》おいぼれ馬 / (…に)…‘を'『ねじでとめる』,ねじくぎ(ねじボルト)で取り付ける《+『down』(『up』)+『名』+『to』(into, on』)+『名』》 / (…に)〈ねじ・電球など〉‘を'回してはめる《+『名』+『on』(『into』)+『名』》 / (…から)…‘を'紋り取る,無理に取る《+『名』+『out of』+『名』》 / 《俗》《受動態で》…‘を'だます,だまし取る / 《俗》〈男が〉〈女〉‘と'性交をする / 〈物が〉(…に)ねじでとまる(つく)《+『to』(『into』)+『名』》 / 〈ねじ・電球などが〉(…に)回してはめこんである《+『into』+『名』》 / 《俗》性交する 
scrim	 スクリム(綿または麻の目のあらい織物;旗・カーテン用) 
scrip	 (非常時に用いる)臨時紙幣・商品券・引替券 
scrod	 タラの幼魚 
scrub	 (たわし・ブラシなどで)…‘を'『ごしごしする』(洗う) / (…から)…‘を'こすり落とす《+『名』+『off』(『out』)+『名』》 / 〈ガスなど〉‘から'不純物を除く / …‘を'延期する;…‘を'取り消す / ごしごしこすってきれいにする / ごしごしとこすること,こすってきれいにすること
scrum	 (ラクビー)スクラム・《英口語》 (満員電車・バーゲンなどに)殺到する群衆・ラグビー)スクラムを組む・なぐり合う,組打ちをする 
scuba	 スキューバ(潜水呼吸用器具) / スキューバの
scurf	 (頭の)ふけ,あか,(一般に)薄くてうろこ状にはげ落ちるもの 
seamy	 いやな,見苦しい / 縫い目のある
sedan	 《米》セダン(2ドアまたは4ドアの箱型の自動車) / =sedan chair
sedgy	 スゲでおおわれた;スゲの,スゲに似た 
senor	 〈C〉…氏,…様(英語の Mr.,Sir に相当) / 〈C〉紳士
sepal	 （花の）萼片(がくへん) 
sepia	 セピア(イカの墨から作る暗かっ色の絵の具) / セピア色,暗かっ色 / セピア色の 
sepoy	 (英国統治時代のインドで編成された)インド現地人兵 
serif	 ひげ飾り(『M』,『H』などの活字の上下につく細く短い線) 
serum	 リンパ液 / 血清
servo	 =servomechanism / =servomotor
setup	 組織,機構 / 《しばしば複数形で》《米》(グラス・ソーダ水・氷など)酒を飲むときに必要なもの一そろい
shack	 掘っ建て小屋 
shade	 〈U〉(光がさえぎられてできる)『陰』;《the ~》日陰 / 《複数形で》《文》夕やみ,夜陰 / 〈C〉『光をさえぎる(和らげる)もの』;日よけ,ブラインド;(電灯などの)かさ / 〈C〉色の明暗の度合い,(濃淡の)色合い / 〈U〉(絵画などの)暗部,陰影 / 《a ~》ほんの少し,ごくわずか(の…)《+『of』+『名』》 / 〈C〉(意味などの)微妙な差,ニュアンス《+『of』+『名』》 / 〈C〉《文》亡霊,幽霊 / 《the shades》《文》死の世界,よみの国 / 《複数形で》《話》サングラス / (光・熱などから)…‘を'陰にする,‘に'陰を作る / 〈絵〉‘に'明暗(濃淡)をつける / 〈色などが〉徐々に(…に)変わる→+『away』(off)『into』+『名』》 
shady	 『陰になっている』,陰の多い / 陰を生ずる / 《話》うさん臭いところがある,うしろ暗い 
shaft	 『矢がら』,やりの柄;矢,やり,ゴルフ棒の柄,旗ざお / (車の)かじ棒 / (機械の)『心棒』,軸,シャフト / (ハンマー・おのなどの)柄,取っ手 / (建物の)柱体,柱身 / 一条の光線 / (鉱山の)縦抗(エレベーターが上下する)シャフト・…‘を'あざむく 
shake	 (前後・上下・左右などに)…‘を'『振る,』揺り動かす,揺する / (…から)…‘を'『振り落とす』《+『名』+『from』(『out of』)+『名』》 / 〈地震・爆発などが〉…‘を'『震動される』 / 〈基礎・信念など〉‘を'『動揺させる,』ぐらつかせる / 〈人〉‘を'動揺させる,』‘を'心をかき乱す / 〈ちり・病気・悪習・追っ手など〉‘を'振り払う,振り切る,除く《+『off』+『名,』+『名』+『off』》 / 『揺れる,』震動する / (恐布・寒さなどで)『振える』《+『with』+『名』》 / 揺り動かす / 〈C〉『揺ること』;揺れ;震え / 《the shakes》《話》(熱・寒けによる)身震い,悪寒(おかん) 
shako	 (前に金層装飾,上に羽飾りのついた)筒形軍帽 
shaky	 (体・声などが)揺れる,震える / こわれそうな,安定していない / 不碓実な,あてにならない 
shale	 頁岩(けつがん),泥板(でいばん)岩 
shalt	 = shall 
shame	 〈U〉『恥ずかしさ』,羞恥(しゅうち)心 / 〈U〉『恥』,恥辱,不名誉 / 〈C〉《単数形で》《話》『恥になる人』(『物』,『事』),面汚し,名折れ / 〈C〉《単数形で》残念なこと,遺憾なこと / 〈人〉‘を'『恥じさせる』,赤面させる / 〈人〉‘の'不名誉になる,面目をつぶす
shank	 (人や動物の)すね / 脚(あし) / 動物の脚から取った肉 / 道具類の取っ手と頭部をつなぐ細い部分
shape	 〈C〉〈U〉『形』,外形,形状・〈U〉状態、調子・〈U〉申分のない体調・〈U〉《時にa~》体つき,姿,なり・〈U〉(物事の)状態・…‘を'『形を作る』・‘を'形づける(give form to);(…の形に)…・‘を'形作る《+『名』+『into』+『名』》・…‘を'形を整える・‘を'合わせる・(…に)…‘を'形を合わせる《+『名』+『to』+『名』》・〈進路・方針など〉‘を'定める・形ができる・具体化する・発展する《+『up』》 
shard	 瀬戸物(ガラス)のかけら 
share	 〈U〉《時にa~》『分け前』,取り分 / 〈U〉《時にa ~》(費用・仕事などの)『分担』,割り当て;(割り当てられた)役割 / 〈C〉『株』,株式,株券 / 〈U〉市場占有率(market share) / …‘を'『共にする』,共に使う;…‘を'分け合う / (…の)『分配にあずかる』,分担をする;(…を)共にする《+『in』+『名』》
shark	 サメ,フカ / 詐欺師,ぺてん師 / 《米俗》名人,達人 
sharp	 (刃・先端が)『鋭い』,よく切れる,よく突きささる / (頂上などが)先がとがっている / (道路などが)『急な』,急カーブの,急こう配の / (言葉などが)『厳しい』,辛らつな / (痛みが)『鋭い』,激しい;(寒さなどが)激しい,身を切るような / (食物が)ぴりっとする,辛い / (音が)鋭い,高い / (輪郭などが)はっきりした,くっきりした / (感覚・頭が)鋭い / 抜け目のない,すばしこい / 油断のない,用心深い / (動作が)速い,機敏な,きびきびした / (身なりの)いきな,スマートな / 《名詞の後にのみ用いて》(音が)シャープの,嬰(えい)音の;調[記]号がシャープ(#)の / 《名詞の後にのみ用いて》(時間を)きっかり,正碓に / 鋭く;急に;油断なく / (音楽で)半音高く / シャープ,嬰音 / シャープ記号(#) 
shave	 〈ひげなど〉‘を'『そる』《+『off』+『名』,+『名』+『off』》 / …‘を'削り落とす,うすく削り取る,〈木板〉‘に'かんなをかける / 《話》…‘を'かする,すれすれに通る / 『ひげをそる』,かみそりをあてる / (…を)かすめる《+『past』+『名』》 / 『ひげそり』 / すれすれに通ること,辛うじて逃れること 
shawl	 ショール,肩掛け 
sheaf	 (稲などの)束《+『of』+『名』》 / (一般に)(…の)束《+『of』+『名』》
shear	 〈毛・羊毛など〉‘を'刈り取る,刈る,刈り込む《+『off』(『away』)+『名,』+『名』+『off』(『away』)》;(…から)…‘を'刈り取る《+『名』+『from』(『off』)+『名』》;〈羊など〉‘の'毛を刈る / 《しばしば受動態で》(…を)〈人〉‘から'はぎ取る,奪い取る《+『名』〈人〉+『of』+『名』》 / 大ばさみ,植木ばさみ 
shelf	 『たな』 / (がけの)岩だな;(海・川の)砂州,岩礁
sherd	 =shard　破片　かけら 
shift	 〈人・場所・位置など〉‘を'『移し替える』,置き換える / …‘を'変える,取り替える / 〈自動車のギヤ〉‘を'入れ変える / (…へ)『変わる』,移る《+『to』+『名』》 / 車のギヤを変える;〈車が〉ギヤが入れ変わる・『変換』,転換;移動 / (仕事、作業の)『交替』,交替製;交替の組(人);交替時間 / (特に,自動車)変速装置 / やりくり[算段],一時しのぎの手段,便法;ずるい手段,策略 / シフトドレス(肩から腰までまっすぐした線のゆったりしたワンピース);スリップ 
shine	 『光る,輝く』,樋り / (…で)〈目・霞などが〉生き生きとする,明るく輝く《『with』+『名』》 / (…のことで)光る,きわだつ《+『in』+『名』》 / (…に)…‘の'『光を向ける』,(…を)…‘で'照らす《+『名』+『on』+『名』》 / 〈靴・銀器など〉‘を'『みがいて光らせる』 / 《時にa~》『光』,花き / 《しばしばa~》靴をみがくこと / 日光;好天気
shiny	 光る,輝く,光沢のある / (服が)着古して光る
shire	 (英国の)州 
shirk	 〈責任・義務・仕事などを〉(ずるけたり，いやがったりして)回避する・(仕事などを)避ける,のがれる《+『from』do『ing』》 
shirt	 (えり付きの男物)『シャツ』,ワイシャツ / 《米》(下着の)シャツ,はだ着(undershirt)
shoal	 浅瀬,州,砂州(さす) / 浅瀬の
shoat	 離乳した子豚 
shock	 〈C〉(衝突・爆発などの)『衝撃』,(地震の)震動,電撃 / 〈C〉〈U〉(精神的)『打撃』,ショック / 〈U〉ショック症 / 《しばしば受動態で》〈人〉‘を'『ぎょっとさせる』,ひどく驚かせる / (治療のため)〈人・動物〉‘に'電気ショクを与える 
shone	 shine の過去・過去分詞 
shore	 〈C〉(海・湖・河の)『岸』,海岸,湖畔,河岸・〈U〉陸・《しばしば複数形で》地方,国(country) 
shorn	 shearの過去分詞 
short	 (長さ・時間・距離などが)『短い』,近い・(人が)『背が低い』・(数量・期間などが)不足の』,乏しい;目標(標準)に達しない・(文などが)『簡潔な』,手短な・『そっけない』,ぞんぞいな,無愛想な・(ケーキなどが)かりかりする,さくさくする・(母音・音節が)短い;(詩の行の母音が)強勢のない・急に,突然・短いもの;欠けているもの・短篇映画(short movie, short subject) ・=short circuit・《複数形で》不足,欠損 / …‘を'短絡させる,ショートさせる / 短絡する,ショートする 
shote	 =shoat 
shout	 『叫ぶ,大声を出す』,どなる《+『out』》 / …‘を'大声で言う,叫ぶ《+『名』+『out,』+『out』+『名』》・『叫び』,大きな呼び声
shove	 …‘を'強く(乱暴に)押す / ぐいと押す,突く / ぐいと押すこと,突くこと 
shown	 showの過去分詞 
showy	 人目を引く,はなやかな / これ見よがしな;飾り立てた
shred	 (特に細長い)切れ端;断語 / 《否定文で》わずか・…‘を'ずたずたに切る(裂く)
shrew	 トガリネズミ(ネズミに似て長くとがった鼻のある哺(ほ)乳動物) / 口やかましい女
shrub	 (根もとからたくさん枝分かれしている)『低木』,かん木 
shrug	 〈骨〉‘を'『すくめる』 / 『骨をすくめる』 / 骨をすくめること 
shuck	 (トウモロコシ・クルミ・豆・カキ・ハマグリなどの)殻(から),さや,皮 / …‘の'殻(さや)を取る / 〈衣服など〉‘を'取り去る,脱ぐ 
shunt	 〈人・物〉‘を'わきにどかす;〈話題など〉‘を'他へそらす / (別の軌道に)〈車両〉‘を'入れ換える / 〈電流〉‘を'わきへそらす;〈分路〉‘を'置く / わきへそれる / 〈車両が〉分岐線に移行する / 〈U〉わきへそれること / 〈C〉転てつ器;(電気の)分路 
sibyl	 (古代ギリシア・ローマの)みこ,女占い師 / 女予言者
sidle	 (こっそりと)横に進む,にじり寄る 
sight	 〈U〉『視力』,視覚(vision)・〈U〉《時にa ~》(…を)『見ること』《+『of』+『名』》・〈U〉見える範囲,視野,視界・〈C〉『景色』,『光景』,眺め・《the sights》『名所』・〈U〉見解・〈C〉《しばしば複数形で》(望遠鏡などの)照準器,照尺,照星・〈C〉《a ~》《話》ひどいもの・《a ~》多数(の…),多量(の…)《+『of』+『名』》;《副詞的に用いて》うんと,ずっと:a sight of money多額の金・…‘を'見つける,認める・ / (照準器で)…‘を'ねらう, ‘に'照準を合わせる
sigma	 シグマ(ギリシア語アルファベットの第18字Σ,σ,ς;英語のS,sに相当) 
silky	 絹のような;柔らかな,すべすべした,つやのある 
silty	 沈泥の;沈泥が詰まった 
since	 《通例完了形またはit is(was)と共に用いて》…『以後』[『ずっと』],…以来[ずっと] / …『ので』,…だから / …『以来』,…から[今まで] / 《完了形とともに用いて》『その時から現在まで』,それ以来ずっと / 《完了形とともに用いて》『その後』[『今までの間に』] / 《過去時制・完了形とともに用いて》(現在より)…前に
sinew	 〈C〉〈U〉筋(きん),腱(けん) / 《複数形で》筋肉 / 活力,体力;力の源泉 
singe	 …‘の'表面を焼く,焦がす / 〈毛髪・糸など〉‘の'先端を焼く / 焦げあと;焦がすこと,先端を焼くこと 
siren	 『サイレン』,『警笛』 / サイレン(ギリシア神話で美声で船人を誘い,殺したという半女半鳥の海の精) / 美声の歌い手;(男を惑わす)美女,妖婦(ようふ) 
sirup	 =syrup 
sitar	 シタール(インド北部の弦楽器) 
sixth	 『第6の』,6番目の / 6分の1の / 〈U〉《the ~》『第6』,6番目[のもの],(月の)6日 / 〈C〉6分の1
sixty	 〈C〉(数の)『60』;60の記号(60,LXなど) / 〈U〉60歳 / 《複数扱い》60人,60個 / 《the sixties》(世紀の)60年代;《one's sixties》(年齢の)60代 / 『60の』,60人の,60個の / 《補語にのみ用いて》60歳の(で)
skate	 =ice skate / =roller skate / 『スケートをする』,氷滑りをする 
skein	 (…の)かせ《+『of』+『名』》 / (…の)もつれ,混乱《+『of』+『名』》 / (飛んでいる野鳥の)群れ 
skier	 『スキーヤー』,スキーをする人 
skimp	 〈金銭・食物など〉‘を'けちけち与える,出し惜しむ / 〈仕事など〉‘を'いいかげんにやる / けちけちする;(…を)つましくする《+『on』+『名』》 
skint	 文なしの,すかんぴんの・= flat-ass broke 
skirl	 バグパイプのピーピーという吹奏の音;金切り声 
skirt	 (女性用の)『スカート』 / (コート・ドレスなどの腰から下の)すそ / (車両・機械などの)すそ部,覆い,スカート / 《複数形で》(…の)周辺,はずれ,郊外《+『of』+『名』》 / 《俗》女,娘(特にa bit of skirt,a piece of skirtの形で快楽の対象としてふざけて) / …‘の'縁(境)にある / …‘を'縁(境)に沿って行く,周辺を回って通る / 〈問題など〉‘を'回避する / (…の)縁(境)にある《+『along』(『around』)+『名』》 / (…の)縁(境)に沿って行く《+『along』(『around』)+『名』》
skive	 仕事をなまける(さぼる) 
skoal	 (健康を祝して)乾杯 
slack	 (綱などが)『緩んだ』,たるんだ / (規則などが)緩い,甘い,とっかりしていない / (動きなどが)遅い,のろい,ぐずぐずした / (商売などが)忙しくない,活発だない / 不注意な,いいかげんな,怠慢な / 〈U〉《the~》緩んだ(たるんだ)部分 / 〈C〉(商売などが)不振(不景気)の時期 / 〈綱など〉‘を'緩める,たるませる,〈速度・努力など〉‘を'緩める,怠る《+『off』(『up』)+『名,』+『名』+『off』(『up』)》 / なまける,怠る;〈綱などが〉緩る,たるむ;〈勢いが〉弱くなる;〈速力が〉のろくなる《+『off』(『up』)》 / 緩く,たるんで;不注意に,いいかげんに
slain	 slay の過去分詞 
slake	 〈渇き〉‘を'いやす / 〈石灰〉‘を'消和する(水を加えて消石灰にすること) / 〈石灰が〉消和する 
slang	 『俗語』,スラング / (特定集団の)『通語』,仲間言葉(jargon) / 〈人〉の悪口を言う,〈人〉‘を'ののしる 
slant	 『傾く,傾斜する』 / …‘を'傾ける,傾斜させる / 《通例受動態で》(特定の立場・読者層に合わせて)〈事実・記事など〉‘を'…向きに書く,ゆがめる《+『名』+『for』+『名』》 / 《a~》『傾斜』,傾き / 観点,見方,見解 
slate	 〈U〉『板岩』 / 〈C〉(特に,屋根瓦用の)『スレート』,粘板岩の薄板 / 〈C〉(昔,筆記に用いた)『石板』 / 〈C〉《米》(党の)公認候補者名簿 / 〈U〉スレート色(濃い青みがかった灰色) / スレート色の / 〈屋根〉‘を'スレート[様の材料]でふく / 《米話》《受動態で》…‘を'選ぶ;…‘を'予定させる
slaty	 スレートの,スレート状の 
slave	 『奴隷』(どれい) / (欲望・習慣・職業などの)『とりこ』,(…に)ふける人《+『of』(『to』)+『名』》,(他人のために)あくせく働く人 / (奴隷のように)あくせく働く《+『away』》 
slept	 sleepの過去・過去分詞 
slice	 (…の)(薄く切った平らな)『一枚』,一切れ《+『of』+『名』》・(…の)分け前(share),一部(part)《+『of』+『名』》・スライス(野球・ゴルフなどで,打球が打者のきき手の方向に飛ぶこと,またその打球) ・料理用へら,フライ返し / 〈パンなど〉‘を'『薄く切る』《+『up』+『名,』+『名』+『up』》・…‘を'薄く切り取る《+『off』+『名,』+『名』+『off』》・〈水など〉‘を'切って進む・(野球・ゴルフなどで)〈ボール〉‘を'スライスさせて打つ,きき手の方向に打つ・(水なとを)切って進む《+『through』+『名』》 / (野球・ゴルフなどで)〈打者が〉ボールをスライスさせて打つ;〈ボールが〉スライスして飛ぶ 
slick	 滑らかな,すべすべした;滑りやすい / 巧妙な,思いつきのよい / 口先のうまい,ずるい,こすい / (文体などが)一見魅力的な / 水面の油,油膜 / 《米話》(上質紙を使った)豪華雑誌(《英》glossy [magazine]) / …‘を'滑らかにする 
slide	 『滑る』,滑って進む《+『on』(『down』)+『名』》 / (ある場所から)(バランスを崩して)〈人が〉『つるりと滑る』,〈物が〉するっと動く《+『from』(『out of』)+『名』》・(ある状態・習慣などに)いつの間にか陥る《+『into』+『名』》・〈時が〉いつの間にか過ぎ去る《+『by』(『past』)》・(…に,…から)(滑るように)そっと動く,人目に立たないように動く《+『into』(『out of』,『from』)+『名』(do『ing』)》・(野球で,走者がタッチを避けようとして,ベースに)滑り込む《+『in』(『into』)+『名』》・《副詞[句]を伴って》…‘を'滑らせる / (…に)…‘を'そっと入れる,滑り込ませる《+『名』+『into』(『under』)+『名』》 / 落ちること,下落 / 滑ること,ひと滑り・滑る面;滑り台・(写真の)スライド・(顕微鏡の)スライド,検鏡板・《複合語を作って》「地滑り,なだれ」の意を表す 
slime	 ねば土; （カタツムリ・魚などの）粘液, ぬめり; 嫌な物・ねば土［粘液］を塗る［除く，で覆う］・どろどろ[ぬるぬる，ねばねば]するもの; (川底などの)軟泥，へどろ・
slimy	 ねば土の;粘液の;どろどろした,ぬめぬめした / きたならしい,いやらしい
sling	 (荷物などをつり上げるための)つり縄,つり鎖 / (銃などの)つり革,負い革 / (負傷した腕などを首からつるための)つり包帯,三角巾(きん)三角巾で腕をつっている / (昔武器に使った)投石器 / 《米》=slingshot / (力まかせに)投げること;(投石器などによる)投石,投げ / (つり縄などで)〈荷物など〉‘を'つり上げる(降ろす),つって運ぶ / 〈銃・ハンモックなど〉‘を'つるす,かける / 《副詞[句]を伴って》〈石〉‘を'投石器で投げる(一般に)…‘を'投げる 
slink	 こっそり動く 
slope	 『傾斜する』,坂になる / …‘を'傾斜させる,‘に'勾配をつける / 〈C〉『坂』,斜面,スロープ / 〈C〉〈U〉『勾配(こうばい)』,傾斜
sloth	 〈U〉怠惰,ものぐさ / 〈C〉ナマケモノ(熱帯アメリカに住む哺乳(ほにゅう)動物)
slump	 (…に)くずれるように落ちる(倒れる,沈み込む)《+『down on』(『to』)+『名』》 / 〈健康・人気などが〉急激に衰える,〈相場などが〉暴落する《+『down』》 / 《おもに米》不調,不振,スランプ / (景気・人気などの)急な衰え,(相場などの)暴落《+『in』+『名』》(反意語はboom)
slung	 slingの過去・過去分詞 
slunk	 slinkの過去・過去分詞 
slurp	 …‘を'音をたてて飲む(食べる) / 音をたてて飲む(食べる)
smack	 (…の)味,風味《+『of』+『名』》 / (…)らしいところ《+『of』+『名』(do『ing』)》 / 《『smack of』+『名』》(…の)味(香り)がする;(…の)気味がある 
smart	 (頭の働きが)機敏な,気のきいた,抜け目のない;悪知恵が働く;(動作が)機敏な,てきぱきした(lively)・現代風の,流行の(fashionable) ・(人・服装などが)きちんとした,いきな,スマートな・ずきんとくる,厳しい,激しい・〈物事が〉ずきんとこたえる・〈傷口などが〉(…が原因で)ずきずき痛む,うずく《+『from』+『名』》・(…で)〈人が〉ずきんと心が痛む《+『from』(『under』)+『名』》・(心・傷口などの)鋭い痛み,うずき《+『of』+『名』(do『ing』)》 
smear	 (油性・粘着性のものを)…に塗る…(…で)…‘を'汚す《+『名』+『with』+『名』〈油など〉》 / (…に)〈油など〉‘を'塗りつける《+『名』〈油など〉+『on』(『over』)+『名』》 / …‘を'こすって不明瞭にする,消す / 〈人の名誉など〉‘を'傷つける,中傷する / 汚れる / かすれる,分鮮明になる / (油などの)汚れ,しみ / 中傷 / (顕微鏡で見るためスライドに塗った)塗布[標本] 
smelt	 smellの過去・過去分詞 
smile	 『ほほえむ』,にっこりする・〈好運・神などが〉(…に)好意を示す《+『on』(『upon』)+『名』》・《a+形容詞+smileを目的語にして》…‘な'笑い方をする・…‘を'ほほえんで示す・〈人〉‘に'ほほえみかけて(…)させる(させない)《+『名』〈人〉+『into』(『out of』)+『名』(do『ing』)》・『ほほえみ』,微笑 
smirk	 (…を)にやにや(にたにた)笑う《+『at』(『on, upon』+『名』)》 / にやにや笑い
smite	 《古・文》(手・武器などで)…‘の'(…を)強く打つ《+『名』+『on』+『名』》 / 《文》〈病気・災難などが〉…‘を'どんと襲う / 《通例受動態に用いて》〈感情・恐怖などが〉…‘を'激しく襲う《+『名』+『by』(『with』)+『名』》 
smith	 かじ屋;金属細工人 / 製造(製作)人
smock	 上っ張り,スモック(婦人・子供・画家・事務員などがはおる) 
smoke	 〈U〉『煙』;煙状のもの / 〈C〉たばこの一服,喫煙 / 〈C〉《話》たばこ,(特に)紙巻きたばこ / 『煙を出す』,煙る;湯気を立てる / 『たばこを吸う』 / 〈たばこ・麻薬など〉‘を'『吸う』 / 〈肉・魚〉‘を'『薫製』(くんせい)『にする』,いぶす 
smoky	 (特にたくさん)煙を出す,もくもくと煙の出る / 煙でいっぱいの / (性質・外観などが)煙のような 
smote	 smite の過去 
snack	 (特に食事と食事の間にとる)『軽食』,スナック / 軽い食事をとる;間食する
snail	 カタツムリ 
snake	 『ヘビ』(『蛇』) / (蛇のように)ずるく陰険な人 / へび(配水管などの詰まった物を取り除く道具) / 蛇行する,くねくねと続く / 〈体など〉‘を'くねらす / 《米》〈材木など〉‘を'引っぱる,引きずる
snaky	 蛇の;蛇のような;うねうねした / 蛇の多い,蛇がよく出る / ずるい,陰険な,邪悪な 
snare	 (小動物を捕らえる)『わな』《+『for』+『名』》 / (人を陥れる)『わな』,落とし穴《+『for』+『名』》 / 〈小動物〉‘を'わなにかける〈人〉‘を'わなにかける,陥れる 
snarl	 (…に)〈犬などが〉歯をむいてうなる《+『at』+『名』》 / (…に)〈人が〉どなる,がみがみ言う《+『at』+『名』》 / 〈言葉など〉‘を'どなるように言う / (犬などの)うなり / ののしり 
sneak	 《場所・方向などを表す副詞[句]を伴って》こそこそ動く / 卑劣なことをする;《英学生俗》先生に告げ口する / …‘を'こっそり取る;《話》…‘を'盗む / 卑劣な人,こすい人;先生に告げ口する人 / こそこそやること 
snick	 (はさみなどで)…‘を'ぱちんと切り取る,…‘に'刻み目をつける / (クリケットで)〈球〉‘を'切って打つ / ぱちっと切ること;刻み目 / (クリケットで)球を切って打つこと
snide	 皮肉たっぷりの,当てこすりの 
snipe	 シギ(湿地帯に生息するくちばしの長い鳥) / (…を)(隠れた場所から)狙撃(そげき)する《+『at』+『名』》 / (匿名などで人・作品を)中傷する,けなす / シギ猟をする
snore	 いびきをかく / いびき
snort	 〈動物が〉強く鼻を鳴らす / (軽べつ・不満・怒りなどを表して)〈人が〉(…に)鼻を鳴らす《+『at』+『名』》 / …‘を'鼻息荒く言う / 《米俗》〈コカインなど〉‘を'吸い込む / 鼻を鳴らすこと(音) / 《話》(ウイスキーなどの)ぐい飲み
snout	 (豚などの突き出た)鼻;鼻先(口とあごも含むことがある) / 鼻先に似たもの;筒口,管先など
snowy	 『雪の』,『雪の降る』 / 雪におおわれた,雪深い / 雪のように白い 
snuck	 sneakの過去・過去分詞 
soapy	 石けんの;石けんの入った;石けんにまみれた / 石けんに似た;すべすべした,なめらかな / 《話》(人・物腰などが)へつらう 
sober	 (酒に)『酔っていない』,しらふの;(ふだん)酒を飲まない / 『まじめな』,謹厳な,重々しい / (色彩・衣服などが)『はででない』,落ち着いた,地味な / 『冷静な』,分別ある / 〈人〉‘の'酔いをさまさせる《+『名』+『up,』+『up』+『名』》 / 〈人〉‘を'冷静にする《+『名』+『down,』+『down』+『名』》 / 酔いがさめる《+『up』》 / 冷静になる《+『down』》
softy	 めそめそした人;軟弱な人 
solar	 『太陽の』,太陽からの;太陽の作用による 
solfa	 ドレミファ音階;ドレミファで歌うこと = sol-fa 
solid	 『固体の』,『固形の』 / 『うつろでない』,中身のつまった / (物質の)密度が高い,密な;(印刷の)行の詰まった / 《名詞の前にのみ用いて》『混じりもののない』,純正の / (構造的に)『堅固な』 / (人が)『信頼できる』,堅実な / 健全な,しっかりした / 一致した,団結した / (時間が)まるまる,切れ目のない;(物が)連続した / 三次元の,立体の,立方の / 『固体』,固形物 / 立方体
solve	 〈問題など〉‘を'『解く』,解明する,解決する 
sonar	 音波水中探知機[sound navigation ranging の頭字語] 
sonic	 音の(に関する) / 音速の
sough	 風がヒューヒュー鳴る, / 風がヒューヒュー鳴る音
sound	 〈C〉〈U〉『音』,『音響』,響き・〈U〉音の聞こえる範囲・〈C〉(音声としての)音 / 《単数形で》(聞いたり,読んだりしたときに受ける)感じ,響き,調子・〈U〉(無意味な)音(声);騒音,ざわめき・『音を出す』,鳴る,響く・『聞こえる,思える』(進行形にできない) ・〈楽器・ベルなど〉‘を'鳴らす・(音で)…‘を'知らせる・…‘を'発音する・〈考えなど〉‘を'打診する
soupy	 （霧が）スープのように濃い, どろっとした; どろどろした・ひどく感傷的な,涙もろい 
south	 〈U〉《通例the south》『南』,南方 / 《the south, the South》南方[地方] / 《the South》(米国の)南部地方 / 『南の』,南部の,南向きの;南からの / 『南の方へ(に)』 
sower	 種子をまく人(機械) / (うわさ・紛争などを)まき散らす人
space	 〈U〉『空間』,広がり / 〈U〉『宇宙』,地球の大気圏外(outer space) / 〈C〉〈U〉『間隔』,距離;《しばしば複数形で》空地 / 〈C〉(特定目的のための)『場所』 / 〈U〉《しばしばa~》時間 / 〈C〉〈U〉スペース,余白,余地 / 〈C〉線間(譜表において五線の間の部分) / …‘を'間隔をおいて配置する《+『out』+『名,』+『名』+『out』》
spade	 『すき』踏みぐわ(シャベルを違って金属部分が平ら) / 〈土など〉‘を'すきで掘る
spake	 （古語・詩）speakの過去
spank	 (罰として平手などで)…‘の'しりをピシャリと打つ / (しりへの)平手打ち
spare	 …‘を'『容赦する』,‘の'命を助ける / 《『spare』+『名』〈人〉+『名』〈労苦〉》〈苦痛・苦労まど〉‘を'〈人〉‘に'させない / 《通例否定文で》〈時間・労力など〉‘を'『惜しむ』,控える / 〈労力・時間など〉‘を'『さく』,割愛する;…‘を'なしですませる / (ある日的のために)…‘を'取っておく,残しておく《+『名』+『for』+『名』》 / (物が)『予備の』;(時間・金が)余分の / (食事などが)質素な;乏しい / やせた(lean) / {名}予備の品(部品),スペア / (ボウリングで)2回の投球でピンを全部倒すこと
spark	 〈C〉『火花』,火の粉;(電気の)スパーク;(一般に)閃光(せんこう),(宝石などの)きらめき / 〈C〉(人などの)活気,生気;(才気などの)ひらめき《+『of』+『名』》 / 〈C〉(事件などの)発端,発火点 / 《a spark》ほんの少し(の…)《+『of』+『名』》 / 火花を出す;閃光を発する;〈電気が〉スパークする / 〈人〉‘を'かり立てて…させる《+『名』〈人〉+『to』(『into』)+『名』(do『ing』)》
spate	 《しばしばa ~》《おもに英》大量,多数(の…)《+『of』+『名』》 / (突然の)供水,鉄砲水
spawn	 (魚・カエルなどの)卵 / 〈卵・子〉‘を'産む / 〈物事〉‘を'生み出す,引き起こす;…‘を'大量に生じる / 産卵する
speak	 『話す』,しゃべる,物を言う,口をきく / 『話をする』,うわさをする / 『演説する』,講演する,スピーチをする / 〈物事が〉表す,物語る / 〈楽器・大砲などが〉音を出す,鳴る / 〈言葉・意見など〉‘を'『言う』,話す,述べる / 〈言語〉‘を'『話す』,使う / 〈物事が〉…‘を'表す,物語る,示す / (海で)〈他船〉‘と'通信する,通話する / …を表す,であることを示す
spear	 『やり』;(魚を突く)やす / (植物の)芽,新芽 / …‘を'やり突く / (植物が)芽を出す
speck	 『しみ』汚点 / 《否定文で》(…の)小片,みじん《+『of』+『名』》 / …‘に'しみをつける 
spelt	 spellの過去・過去分詞 
spend	 (…に)〈金〉‘を'『使う』《+名〈金〉+on(『for』)+『名』》 / 〈時〉‘を'『過ごす』 / 《文》〈力など〉‘を'使い果たす,〈自分〉‘の'力を使い果たす / 金(財産など)を使う;浪費する
spent	 spendの過去・過去分詞 / 彼れきった / 使い尽くした 
sperm	 〈C〉精子 / 〈U〉精液
spice	 〈C〉(こしょうなど,個々の)『薬味』;〈U〉《集合的に》『香辛料』,スパイス / 〈U〉ぴりっとするもの,妙味 / 《a ~》(…)気味,(…)らしいところ《+『of』+『名』》 / 〈料理など〉‘に'薬味を加える(薬味で)〈料理〉‘を'調味する《+『名』+『with』+『名』》 / (…で)〈話など〉‘に'趣を添える,おもしろ味を加える《+『名』+『with』+『名』》 
spicy	 (料理などが)薬味のきいた,風味のある:spicy food・(批評など)ぴりっとした;(言葉など)きわどい 
spiel	 (説得のための)多彩なおしゃべり,口先だけの話,客寄せ口上 
spike	 大くぎ;(鉄道用)いぬくぎ / (へいの忍び返しなどの)先のとがった突起 / スパイク(野救・陸上競技用の靴底の金具) / (…に)…‘を'大くぎで打ちつける《+『名』+『to』+『名』》 / …‘に'大くぎ(スパイク)を打ちつける / 〈人〉‘を'スパイクシューズで傷つける;スパイクする
spiky	 くぎの先端があちこちに出ている;くぎだらけの / くぎのようにとがった / 《話》がんこな 
spilt	 spillの過去・過去分詞 
spine	 (またspinal column,《話》backbone)せき柱,背骨 / (書物などの)背 / (ヤマアラシ・サボテンなどの)針,とげ 
spiny	 とげのある,とげだらけの / とげ状の,とげのような
spire	 (教会などの)『尖塔』(せんとう);(尖塔の)とがり屋根 / 先のとがった物
spirt	 =spurt 
spite	 悪意,意地悪 / 《a ~》(…への)恨み《+『against』(『at』)+『名』》 / 〈人〉‘に'意地悪をする,‘を'困らせる 
splat	 (いすの背の)薄板,背板 
splay	 外側へ広がった(開いた) / ぶざまな,ぶかっこうな / 斜面,隅切り(窓や扉の両側面の壁が傾斜した部分) / …‘を'広げる,伸ばす / …‘を'斜めにする;〈窓や扉[の壁面]〉に斜角をつける 
split	 …‘を'『縦に割る』,裂く / …‘を'分割する,ばらばらに分ける / 〈利益など〉‘を'『分配する』,分け合う;〈費用など〉‘を'分担する《+『up』+『名』,+『名』+『up』》 / 『割れる』,裂ける / 『壊れる』,砕ける,破裂する;(部分などに)分かれる,分裂する《+『up』》;(…と)けんかする《+『with』+『名』》 / (急いで)去る,帰る(leave);姿を消す / (…の)割れ(裂け)目;ひび《+『in』+『名』》 / 仲間割れ,分裂 / 分け前 / 《しばしば複数形で》(曲芸などの)大股(おおまた)開き / (ボーリングで)スプリット(残ったピンが離れていてスペア(spare)を取りにくい形になること) / 《話》(ソーダ・アルコール飲料などの)小びん / (縦に)裂けた,割れた / 分裂した,分割された
spoil	 〈物事〉‘を'『だいなしにする』,損なう / 〈子供など〉‘を'『甘やかしてだめにする』,増長させる / 《古》(…を)…‘から'奪う《+『名』+『of』+『名』》 / 〈物が〉『だいなしになる』,だめになる / 〈C〉《複数形で》『略奪品』,強奪品,戦利品 / 〈C〉《複数形で》《おもに米》(政権をとった政党が支持者に与える)利権,役職 / 〈U〉(採鉱・発掘などの際に廃棄される,土・石などの)くずもの 
spoke	 speakの過去 
spore	 胞子;胚種 
spork	 スポーク 
sport	 〈U〉《集合的に》『スポーツ』,運動競技 / 〈C〉(個々の)『スポーツ』,運動競技 / 《複数形で》《英》運動会,競技会 / 〈U〉『気晴らし』,慰め,娯楽 / 〈C〉《話》スポーツマンらしい人,さっぱりした人,いい人 / 〈C〉(動・植物の)変種(mutant) / スポーツの;スポーツ用の / (服装が)戸外の着用に適した,軽快な / 〈衣服など〉‘を'見せびらかす / 《文》(気晴らしなどで)楽しむ,遊ぶ / からかう 
spout	 〈水・煙など〉‘を'吹き出す / 〈意見など〉‘を'とうとうと述べる(まくしたてる) / 〈水・煙などか〉吹き出る,噴出する《+『out』》 / とうとうとまくしたてる / (やかん・ポンプなどの)口,噴出口 / (液体などの)噴出,ほとばしり《+『of』+『名』》
sprat	 スプラットイワシ 
spray	 (花・葉・実をつけた)小枝;小枝形の装飾;小枝模様 
sprig	 (花や葉のついた)小枝 / (織物・壁紙などの)小枝 / 《軽べつして》若造 / 〈つぼ・布地など〉‘を'小枝模様で飾る
spume	 あわ(foam) / あわ立つ
spunk	 勇気,気力 
spurn	 〈申し出・人など〉‘を'はねつける,相手にしない 
spurt	 〈液体などが〉噴出する,ほとばしる《+『out』》 / スパートする,力走(力泳)する / 〈液体など〉‘を'噴出させる,ほとばしらせる / (液体などの)噴出,ほとばしり;(感情・エネルギーなどの)激発 / (レースの途中や最後の)力走,力泳,力闘 
squab	 (食用の)ひなバト 
squad	 (軍隊の)分隊 / (一般に少人数の)班,団,組;(運動競技などの)チーム
squat	 しゃがむ,うずくまる(crouch)《+『down』》 / 〈動物などが〉地に伏す,身をひそめる / (他人の土地に)無断で定住する / (所有権獲得の目的で政府の規制に従いながら)公有地に定住する / 《英話》座る(sit) / しゃがんだ / ずんぐりした / うずくまること;しゃがんだ姿勢
squaw	 (北米インディアンの)女,妻;《おどけて》女房 
squib	 小花火,かんしゃく玉 / (特に政党・政治家への)風刺文,あてこすり
squid	 ヤリイカ 
stack	 『干し草の山』,麦わらなどの山,いなむら / (一般に,物を積み上げた)『山』,(…の)積み重ね《+『of』+『名』》 / (図書館などの)書架,ラック;《複数形で》(特に,図書館などの)書庫 / 煙突 / 《しばしば複数形で》《話》多数,多量(の)《+『of』+『名』》 / 〈干し草・本・皿など〉‘を'積み重ねる《+『up』+『名,』+『名』+『up』》 / (…を)〈ある場所〉‘に'積み上げる《+『名』+『with』+『名』》 / 《米話》(…に対して)〈カード〉‘を'不正な切り方をする《+『名』+『against』+『名』》 / 〈飛行機〉‘を'空港上空で旋回待機させる / 山に積まれる,山になる / 〈飛行機が〉空港上空で旋回待機する 
stage	 (劇場・ホールなどの)『舞台』・on stage 舞台上で・《無冠詞》・off stage 舞台の陰で 《無冠詞》：ステージ;演壇;《the~》演劇;俳優業,演劇(舞台)の仕事 / (事件・活動などの)『舞台』,場所 / (発達などの)『段階』,時期 / (駅馬車などの止まる)駅,宿場;休憩地;(旅行における休憩地間の)旅程,行程 / =stagecoach / (多段ロケットの)段 / 〈劇〉‘を'『上演する』,〈試合など〉‘を'公開する / (特に劇的に)…‘を'実行する,やってのける
stagy	 舞台の,芝居の / 芝居がかった,大げさな
staid	 落ち着いた,着実な,まじめな 
stain	 (…で)…‘を'『汚す』,‘に'しみをつける《+『名』+『with』+『名』》 / 〈ガラス・木材・布など〉‘に'『着色する』 / (…で)〈人格・名声など〉‘を'汚す,‘に'傷をつける《+『名』+『with』+『名』》 / 汚れる,しみがつく / 〈C〉〈U〉(…についた)『しみ』,汚れ《+『on』+『名』》 / 〈U〉〈C〉着色剤,染料 / 〈C〉(人格・名声などに対する)汚点,傷《+『on』(『upon』)+『名』》 
stair	 〈C〉(階段の一つの)『段』 / 《複数形で》『階段』
stake	 (境界標・植物の支えなどの)『くい』 / 火刑用の柱;《the~》火刑,火あぶり / 《しばしば複数形で》(競馬・ゲーム・かけ事などの)かけ金,賞金;(賞金のかかった)レース,(特に)競馬 / (…に対する)(金銭的・感情的な)利害関系《+『in』+『名』(do『ing』)》 / 〈境界など〉‘を'『くいで印をする』,くいで区画する《+『out』(『off』)+『名』,+『名』+『out』(『off』)》 / 〈動物など〉‘を'くいにつなぐ;〈植物など〉‘を'くい支える / (…に)〈金・名誉・命など〉‘を'かける《+『名』+『on』+『名』》 / 《米》〈人〉‘に'(…の)金を出してやる《+『名』+『to』+『名』》
stale	 (食物などが)『新鮮でない』,腐り始めた;(酒などが)気の抜けた;(空気などが)むっとする / 新鮮さを失った,古くさい,陳腐な / (過老・退屈などで)生気がない,頭のぼんやりした,(練習不足などで)調子をくずした / 古くさくなる,気が抜ける;陳腐になる
stalk	 《しばしば複合語を作って》『茎』;葉柄 / 細長い支え
stamp	 〈地面・床など〉‘を'『踏みつける』;〈足〉‘を'踏み鳴らす;…‘を'踏みにじる,踏みつぶす / …‘に'『印』(『判』)『を押す』;(印などを)…‘に'押す《+『名』+『with』+『名』〈印〉》;(…に)〈印など〉‘を'押す《+『名』〈印〉+『on』+『名』》 / 《しばしば受動態で》(印象などを)〈心など〉に刻みつける《+『名』+『with』+『名』〈印象〉》;(心などに)〈印象など〉‘を'刻みつける《+『名』〈印象〉+『on』(『in』)+『名』》 / …‘に'切手(印紙)をはる / (…であると)〈事が〉〈人〉‘を'はっきり示す《+『名』〈人〉+『as』+『名』(『形』)〈補〉》 / …‘を'押しつぶす,粉砕する;…‘を'粉々にして(…に)する《+『名』+『into』(『to』)+『名』》 / 踏みつける,足を踏み鳴らす;足を踏み鳴らして歩く / 〈C〉『切手』(postage stamp),[収入]印紙,証紙 / 〈C〉『判』,印章;押し型,抜き型 / 〈C〉(判・押し型などで押した)印,スタンプ,消し印,検印 / 〈U〉特質,特徴,印 / 〈U〉種類,型 / 〈C〉足踏み,踏みつけること,じだんだ 
stand	 〈人・動物が〉『立つ』,立っている / (すわっていたのが)『立ち上がる』,起立する《+『up』》 / 〈物が〉(ある場所に)『立っている』,立てかけてある,置かれている / 《副詞[句]を伴って》『位置する』ある(進行形にできない) / 〈人物が〉状態(関係)にある / 〈人が〉(…に)(賛成・反対の)態度をとる,主張をする《+『for』(『against』)+『名』》 / 《『stand』+『名』(『形』)〈補〉》〈身長・得点・温度・順位などが〉(…で)ある / 立ち止まる;〈車・機械などが〉停止している / 〈主張などが〉変わらないでいる,ぐらつかない;〈規則などが〉有効である(進行形にできない) / 〈水などが〉よどむ;〈涙・汗などが〉たまる / 《副詞[句]を伴って》(船が)針路をとる / …‘を'『立てる』,立たせる,立てかける;…‘を'置く,すえる / …‘に'『立ち向かう』;…‘に'ひるまない;…‘を'守り通す / 《追例否定文で》…‘に'『耐える』,‘を'がまんする(進行形にできない) / 〈検査など〉‘を'受ける;〈運命など〉‘に'従う / 《話》…‘を'おごる / 〈任務など〉‘を'務める / 『立つこと;立ち止まること』,停止 / 防御,抵抗 / 立場,(明確な)態度,意見 / 位置,場所 / 《しばしば複合語を作って》『台』,…立て,…掛け / 《米》=witness stand / 『屋台店』,売店 / (タクシー・バスなどの)駐車場・乗り場 / 《通例the stands》『観覧席』,さじき,スタンド / (同一の地域・種類・樹齢の)立ち木,樹木,草木,作物 / (巡業興行団の)巡業[先],巡回[地]
stank	 stinkの過去 
staph	 =staphylococcus 
stare	 (…を)(目を大きく開いて)『じっと見つめる』,じろじろ見る,凝視する《+『at』(『into』)+『名』》 / 〈色などが〉目見つ / …‘を'『じっと見つめる』,じろじろ見る,凝視する / 〈人〉‘を'にらみつけて(…)させる《+『名』〈人〉+『into』(『to』)+『名』》 / 『じっと見つめること』,凝視 
stark	 《名詞の前にのみ用いて》全くの,正真正銘の / (景色・場所などが)荒れた,ものさびしい / (気候が)きびしい / (顔・態度が)こわばった,堅い
stave	 おけ板,たる板 / (はしごの)段,横木 / 詩句・節,連(stanza, verse) / (音譜を記入する)譜表,五線(staff) / …‘に'穴をあける,‘を'突き波る《+『名』+『in』,+『in』+『名』》 / 穴があく,突き波られる
stead	 代わり;役だち.助け 
steak	 『ステーキ』,(特に)ビフテキ(beefsteak);(料理用の肉・魚の)厚い切り身 
steal	 (…から)〈物〉‘を'『盗む』《+『名』〈物〉+『from』+『名』》 / (…から)…‘を'こっそり取る,うまく手に入れる+『名』+『from』+『名』》 / (野球で)〈塁〉‘を'盗む,‘に'盗塁する / 盗みをする / 《方向・場所を表す副詞[句]を伴って》こっそり動く / 〈U〉《米話》こっそりと盗むこと;〈C〉盗品 / 〈C〉《単数形で》《米話》格安品,掘り出し物 / 〈C〉(野球で)盗塁
steam	 『蒸気』,湯気,水蒸気 / 蒸気の力 / 《話》力,精,力,元気 / …‘を'蒸気にさらす,蒸す / 『[水]蒸気を出す』,湯気をたてる《+『away』》 / 《副詞[句]を伴って》蒸気で動く / 《話》怒る,いきまく 
stein	 (陶器製の)ビール用コップ;ジョッキ;ジョッキ1杯の量(約0.5l) 
steno	 =stenographer / =stenography
stern	 『厳格な』,断固とした / 手厳しい,容赦のない / (顔つきなどが)『いかめしい』,険しい 
stick	 (とがったもので)…‘を'『刺す』,突く《+『名』+『with』+『名』》 / (…に)〈とがったもの〉‘を'『突き刺す』,突き立てる《+『名』+『in』(『into, through』)+『名』》 / (…で…に)…‘を'『刺して留める』,刺す《+『名』+『on』+『名』+『with』+『名』》 / (のりなどで…に)…‘を'『はる』,くっける《+『名』+『on』+『名』+『with』+『名』》 / 《話》(…に)…‘を'置く,すえる(put)《+『名』+『on』(『in』)+『名』》 / 《受動態で》〈人・車など〉‘を'『動けなくする』,〈仕事など〉‘を'行き詰まらせる / 《話》〈人〉‘を'困惑させる;〈人〉‘を'だます,‘に'たかる / (…に)『突す刺さる』,刺さっている《+『in』+『名』》 / 『くっついて離れない』,はりつく / 動かなくなる,立往生する
stile	 踏み段(かき・へいなどにつけて人だけ通して家畜を通れないようにしたもの) / 回転木戸(turnstile)
sting	 〈動植物が〉(針・とげなどで)…‘を'『刺す』 / 〈神・舌など〉‘を'『ひりひりさせる』,ちくちくさせる / 〈人〉‘の'『心を苦しめる』 / 〈人〉‘を'刺激して(…)させる,駆りたてて(…)させる《+『名』+『to』(『into』)+『名』(do『ing』)》 / 《俗》(…という大金を)〈人〉‘から'だまし取る,ぼる,《+『名』〈人〉+『for』+『名』》 / 〈ハチなどが〉『刺す』 / 〈体の一部が〉刺すように痛む / 〈香辛料などが〉ひりひりした味方がする / 苦しむ,いらいらする;〈つらい事などが〉心を苦しめる / 〈C〉『刺すこと』 / 〈C〉〈U〉『刺し傷』,刺された痛み / 〈C〉〈U〉(心・体の)激しい痛み / 〈C〉皮肉,あてこすり / 〈C〉(ハチなどの)針,(ヘビなどの)毒牙,(バラなどの)とげ
stink	 悪臭を放つ;(…で)臭い《+『of』+『名』》 / 《話》鼻持ちならない,ひどく評判が悪い / 《話》非常に劣っている / 〈場所など〉‘を'いやな臭いにする《+『up』+『名』》 / 悪臭 / 《米話》騒動,物議
stock	 〈C〉〈U〉(…の)『在庫品』,仕入れ品,ストック《+『of』+『名』》 / 〈C〉〈U〉(…の)貯蔵,蓄え《+『of』+『名』》 / 〈U〉《集合的に》『家畜』 / 〈U〉血統,家系,家柄 / 〈U〉〈C〉(動植物の)種属 / 〈U〉(スープ種・ソース種などに用いる)煮出し汁 / 〈U〉〈C〉《おもに米》(株式会社の)株,株式;〈C〉株券,《英》国債,地方債 / 〈U〉原料 / 〈C〉《複数形で》(刑罰用の昔の)さらし台 / 〈C〉(銃の)台じり / 〈C〉(接ぎ木の)台木 / 〈C〉(接ぎ穂をとる)親株 / 〈C〉(植物の)幹,茎 / 〈C〉(錨(いかり)のリングの下の)横棒 / 〈C〉(劇場の)専属劇団[のレパートリー] / 〈C〉アラセイトウ(春,赤紫色の花を開く) / (商品を)〈店など〉‘に'『仕入れる』,蓄える《+『名』〈店〉+『with』+『名』〈商品〉》 / …‘を'『仕入れている』,貯蔵している / (家畜などを)〈農場など〉‘に'入れる,(…を)〈川・草地など〉‘に'放つ《+『名』〈農場など〉+『with』+『名』》 / (…を)仕入れる,蓄える《+『up with』+『名』》 / 常に仕入れてある,常置の;標準の / ありふれた,陳腐な / 在庫品を扱う 
stoic	 (苦しみ・喜びなどに)無関心な人,克己心の強い人;禁欲(克己)主義者 / 《『S』‐》ストア派哲学者 / (苦しみ・喜びなどに)無関心な,禁欲(克己)的な 
stoke	 〈火〉‘を'かき立てる;〈炉など〉‘に'燃料をくべる《+『up』+『名』,+『名』+『up』》 / 火をかき立てる;火(炉)の番をする《+『up』》
stole	 ストール(牧師が肩からたらす絹のけさ) / (婦人用の)肩掛け,ストール
stoma	 気孔(葉・茎の表皮にあって気体の出入りに役立つ小さな穴) 
stomp	 〈床・地面など〉‘を'踏みつける / (力を込めて)〈足〉‘を'踏みおろす / (力を込めて)踏みつける / ストンプ(力強いリズムとテンポの早い初期のジャズおよびそのダンス)
stone	 〈U〉(物質としての)『石』,石材 / 〈C〉『小石』,岩石の小片 / 〈C〉《複合語を作って》(特定の目的に用いる)石材 / =precious stone / 〈C〉(形・堅さが)石に似たもの(あられなど) / 〈C〉(腎臓・膀胱(ぼうこう)などの)結石 / 〈C〉(果実の)種,核 / 〈C〉《英》(体重を表す重量単位の)ストーン(14ポンド(約5.35キログラム)に相当) / 『石造りの』,石の・石器製の / …‘に'石を投げる,石を投げて殺す / …‘に'石を取り付ける(張る,敷く),沿って石を並べる / 〈果実〉‘の'種を取る
stony	 『石の』,石の多い / 石のように堅い / 無情な,冷酷な,無表情な 
store	 〈C〉《おもに米》[小売]『店』,商店(《英》shop) / 〈C〉(…の)『蓄え』,貯蔵《+『of』+『名』》 / 〈C〉多量,多数,たくさん(の…)《+『of』+『名』》 / 《複数形で》必需品,備品,用品 / 〈C〉倉庫,貯蔵所 / (将来のために)…‘を'蓄える』《+『up』+『名』》 / …‘を'『倉庫に保管する』 / (…を)〈ある場所など〉‘に'供給する,用意する《+『名』〈場所〉+『with』+『名』》
stork	 コウノトリ 
storm	 『あらし』,暴風[雨],荒天 / (感情・言動などの)『あらし』,激発《+『of』+『名』》 / (一般に)激動,波乱,騒動 / (弾丸などが)雨あられと飛ぶこと《+『of』+『名』》 / 《itを主語にして》〈天候が〉『荒れる』 / 猛然と突進する;激しく怒る / …‘を'強襲する,急襲する 
story	 〈C〉(事実に基づいた)『話』,実話 / 〈C〉(架空の,人を楽しませる)『物語』,話 / 〈U〉(小説,詩,劇,映画などの)筋,プロット / 〈C〉(新聞などの)記事,事件の報道 / 〈C〉(ある人の言う)言葉,申し立て / 〈C〉《話》《子供が,また子供に対して用いる》うそ(lie)
stoup	 聖水盤(教会堂の入口にあり,出入りの際指を浸して十字を切る) 
stove	 『ストーブ』,暖炉 / 『料理用レンジ』(cooker)
strap	 (革製や布製の)『ひも』,バンド,帯;(電車の)つり革 / (金属製の)帯金,バンド / 《the ~》むち打ち,せっかん・ひも(バンド)で縛る,留める《+『名』+『on』(『in, into』)+『名』》・むちで打つ・《英》=tape{動 
straw	 〈U〉《集合的に》『麦わら』,『わら』 / 〈C〉(1本の)『わら』 / 〈C〉(飲み物を飲むときに使う)『ストロー』 / 〈U〉《しばしばa~》《否定文で用いて》つまらない物;ごくわずか
stray	 (…から)『それて道に迷う』,さまよい出る,はぐれる《+『from』+『名』》 / 〈考え・話題などが〉(…から)わきへそれる《+『from』+『名』》 / 『道に迷った』,はぐれた / 飼い主のいない / まばらの,離れ離れの,時たまの / (弾丸などが)それた / 浮浪児,迷い子 / 迷った動物;野良犬(猫)
strep	 =streptococcus 
strew	 …‘を'振りまく,ばらまく(scatter) / (…を)…‘に'まき散らす《+名+with+名》
stria	 (平行に並んでいる)細い溝(筋) / 条線(氷河運動により岩の表面についたかき傷;鉱物の結晶面に走る平行線) / (円柱についている)縦溝 
strip	 …‘を'『裸にする』;(…を)…からはぎ取って裸にする《+名+of+名》 / (…から)…‘を'『取り去る』,はぎ取る《+名+off(+off+名)+from+名》 / (権利・栄誉・持と物などを)〈人など〉‘から'『奪う』,剥奪する《+名〈人〉+of+名》 / 〈ボルト・ギア・ねじなど〉‘の'ねじ山をすり減らす / 服を脱ぐ,裸になる《+off》 
strop	 (かみそりをとぐ)皮砥 / 〈かみそり〉‘を'皮砥でとぐ
strum	 〈弦楽器・曲〉‘を'気ままに弾く,つまびく,かき鳴らす / (…を)気ままに弾く,つまびく《+on+名》 / つまびき[の音] 
stuck	stick の過去・過去分詞 / 動かない,固定している,粘着している / 動けない,(支障があって)進行が止まっている・「stuck on 何々」で「何々に夢中になっている・惚れ込んでいる」 
study	 〈U〉(一般に)『勉強』,学習すること / 〈C〉(…の)勉強,研究《+of+名》 / 〈C〉〈U〉(…の)『綿密な調査』,検討《+of+名》 / 〈C〉研究対象(問題,事項);学科 / 〈C〉『書斎』,勉強部屋 / 〈C〉(美術・文学などの)習作,試作,スケッチ,(音楽の)練習曲,エチュード / …‘を'『勉強する』,学ぶ,研究する / …‘を'『よく注意して見る』,しげしげと見る / …‘を'『調査する』,検討する / …‘を'考慮する,配慮する / 〈せりふなど〉‘を'覚えようとする / 『勉強する』,学ぶ,研究する
stump	 (木の)『切り株』 / (一般に主要部分を除いた)『残部』,残片;(特に手足の)切れ残り / (政治演説の)演壇[米国で開拓時代に切り株を演壇に用いたことから] / 《話》〈人〉‘を'困惑させる,困らせる,閉口させる / 《副詞[句]を伴って》ぎごちなく(重い足どりで)歩く,ドタドタ歩く / 政治演説して回る,遊説する
stung	 stingの過去・過去分詞 
stunk	 stinkの過去・過去分詞 
style	 〈C〉〈U〉(服装などの)『流行[型]』,スタイル / 〈C〉(衣服・物腰・ふん囲気などの)優雅さ,上品 / 〈C〉〈U〉(個人・集団・時代などに特有の)『様式』,型;文体,口調 / 〈C〉(商品などの)種類,形式 / 〈C〉称号,肩書き,呼び名 / 〈C〉鉄筆(stylus) / 〈C〉(植物の)花柱 / 〈U〉〈C〉印刷様式,体裁 / 〈服装・家具など〉‘を'流行に合わせてデザインする(作る) / (特定の印刷様式に合わせるため)〈原稿など〉‘に'手を加える / 《style+名+名〈補〉》(…と)…‘を'呼ぶ,称する 
styli	 stylusの複数形 
suave	 (内心はともかく表面上は)人当たりのよい,もの柔らかな 
sugar	 〈U〉砂糖 / 〈C〉(1個・さじ1杯の)砂糖 / 〈U〉庶糖 / 《話》(恋人に対して呼び掛けて)ねえ / …‘に'砂糖を混ぜる(かける);…‘に'砂糖を加えて甘くする 
suite	 (ホテルなどで寝室・居間・客間などの)一続きの豪華な部屋 / (家具などの)一そろい,一組 / (いっしょに使われるものの)一続き,一組,一そろい / (楽曲の一形式である)組曲 / 《集合的に》《まれ》随行員,従者の一行 
sulky	 すねた,ふくれっつらの / (物事が)不活発な,のろい
super	 (アパートなどの)管理人,長官,所長,監督(superintendent) / (映画の)エキストラ,端(は)役(supernumerary) / 特等品,特製品 
supra	 上に(above) / (書物の)前の方に
surge	 波のように押し寄せる,殺到する / 〈感情が〉こみあげる《+up》 / 急増する,〈株などが〉急騰する / (…が)押し寄せること,(…の)襲来,殺到《+of+名》 / (感情の)高まり,急増,急騰 
surly	 (人・行為などが)不きげんな,無愛想な 
sutra	 (仏教・バラモン教の)経典 
swage	 型鉄 / …‘を'型鉄で曲げる(型をつくる)
swain	 いなかの若者 / 恋人,求婚者
swami	 ヒンズー教の学者(聖職者)(の尊称) 
swamp	 『沼沢地』,沼地,湿地 / 《しばしば受動態で》(困難なことや仕事などが)…‘に'押し寄せる,‘を'圧倒する / …‘を'水浸しにする;〈船など〉‘を'沈没させる / 圧倒される,窮地に陥る / 〈船〉が沈没する,浸水する 
swank	 〈U〉見せびらかし,気どり / 〈C〉きざな人,いばっている人 / いばって歩く(ふるまう),見せびらかす 
sward	 芝生 
swarf	 (金属やプラスチックなどの)削りくず 
swarm	 (大きな一団となって飛んで(動いて)いる昆虫などの)『群れ』《+of+名》 / (人・動物・物の)『群れ』,多数《+of+名》 / 〈ミツバチが〉巣分かれする,分封する / 『群れをなして動く』 / 〈場所が〉(で…)一杯になる,あふれる《+with+名》 
swath	 (草刈り機で刈り取った後の)刈り草(刈り麦)の列 / (かまなどの)刈り幅
swear	 (神などにかけて)『誓う,』宣誓する / (宣誓して)(…を)『証言する』《+to+名(doing)》 / 『罰当たりな言葉を使う,』(…を)ののしる《+at+名》 / (神などにかけて)…を‘誓う,'誓って言う / 《話》《swear+that節》…だと断言する,主張する / (…を)〈人〉‘に'誓わせる,宣誓させる《+名+to+名(doing)》
sweat	 〈U〉『汗』 / 〈U〉(一般に,物の表面にできる)湿気,露,水滴 / 〈U〉《しばしばa ~》発汗[状態];〈C〉発汗作用 / 〈U〉《しばしばa ~》《話》心配(いらだち,怒り)の状態 / 〈U〉《しばしばa ~》骨折り,つらい労働 / 『汗をかく』 / (一般に,物の表面が)湿気を帯びる,汗をかく / 《話》汗水流して働く / 〈水分〉‘を'毛穴などから出す / …‘に'汗をかかせる / 〈体重など〉‘を'汗を流して減らす《+away(off)+名,+away(off)+名》 / …から水分を出させる / 〈人・馬など〉‘を'汗水流して働かせる,酷使する 
swept	 sweep (掃く, 払う, 掃除する) の過去・過去分詞 
swift	 『速い』,快速の / (行動・反応などが)『即座』の,さっそくの;『す早い』,機敏な / 《おもに詩》つかのまの / 速く;す早く / アマツバメ(翼の長い鳥;高山や断崖に群棲) 
swine	 《米》《集合的に》豚(pig) 
swing	 (一定の動きで)…‘を'『振る』,揺り動かす / (一点を軸にして)…‘を'『回転させる』,ぐるりと回す / 〈棒など〉‘を'『振り回す』 / …‘を'向きを変える / 〈物〉‘を'『つるす』,掛ける / 《米話》〈取引きなど〉‘を'うまく処理する,思いどおりに操る / (…から別の意見・立場などに)…‘を'変える《+from+名+to+名》 / 《副詞[句]を伴って》(一定の動きで)『揺れる』,揺れ動く;ぶらんこに乗る / (一点を軸にして)『回転する』,ぐるりと回る / (大きく弧を描くように)(…を)打つ《+at+名》 / (…の方に)向きを変える《+on(onto,to,into)+名》 / のびのびと調子よく歩く,活動的になる / 《話》(…のことで)絞首刑になる《+for+名》 / (別の意見・立場などに)変わる《+to(toward)+名(doing)》 / 《話》〈音楽が〉スイング風である(に演奏する) / 〈C〉〈U〉(一定の動きを伴う)揺れ,振動;(ある方向への)揺れ動き《+toward+名》 / 〈C〉振幅 / 〈C〉『ぶらんこ』;ぶらんこ遊び / 〈U〉《しばしば a~》リズミカルな動き(歩き方) / 〈C〉(…を)大きく振ること,打つこと《+of+名》 / 〈U〉活動の自由 / 〈U〉スイング(1930‐40年代のジャズのリズム) / 〈C〉各国・各大陸を飛び歩く 
swipe	 大振りの打撃,強打 / …‘を'大振りで打つ,強打する / 《話》…‘を'盗む,かっぱらう / (…を)強打する《+at+名》
swirl	 うず巻く,旋回する / …‘に'うず巻きを起こす;…‘を'旋回させる / 旋回すること,回転 / (水・ほこりなどの)大量のうず《+of+名》 / うず巻き形;巻き飾り;巻き毛 
sword	 『刀』,剣 / 《the ~》武力,兵力
swore	 swear の過去 
sworn	 swear の過去分詞 / 誓った,契った / 宣誓による 
swung	 swing の過去・過去分詞 
sylph	 空気の精 / ほっそりした美しい女
synod	 教会会議 
syrup	 シロップ(砂糖や果汁を煮詰めて作る甘い汁) / (薬用の)シロップ剤
table	 〈C〉『テーブル』,食卓;(仕事・遊戯などの)台 / 〈U〉《時にa~》食べ物,料理 / 《集合的に》テーブルを囲む人々,一度の人々 / 〈C〉(文字・数字,情報などの並べた)『表』,配列表,目録 / =tableland / …‘を'表にする / 《おもに米》〈議案など〉‘を'棚上げにする,見送る / 《英》〈議案など〉‘を'審議に付す
tabor	 テイバー(昔,竪笛の伴奏に用いたタンバリンに似た小太鼓) 
tacky	 ねばねばする(sticky) 
taken	 take の過去分詞 
talon	 (特に猛鳥の)つめ 
talus	 (くるぶしの)距骨;くるぶし,足首 
tamer	 (動物の)調教師 
tango	 〈C〉タンゴ(南米に発した踊り) / 〈C〉〈U〉タンゴの曲 / タンゴを踊る 
tangy	 (味が)ぴりっとする;においが強い 
tansy	 〈C〉コモギギク[属](小さな黄色い花の房をつける) / 〈U〉(薬用・食用の)ヨモギギクの汁
taper	 小さい先細のろうそく / しだいに先細になること / …‘に'先細にする;…‘を'次第に少なくする《+off+名,+名+off》 / だんだん細くなる,だんだん少なくなる《+off》
tapir	 バク(中南米・東南アジア産の有蹄動物) 
tardy	 《米》遅れた,遅刻した;(…に)遅れた《+for(at,in,to)+名》 / 遅い,遅々とした;(…が)遅い《+in(at)+名(doing)》
taupe	 暗灰色(茶・黄・紫色がかった灰色) / 暗灰色の
tawny	 黄褐色の 
teach	 〈物事・学科など〉‘を'『教える』,〈人〉‘に'教える / (…で)『教師をする』,教える《+at+名》
tempo	 (仕事・活動などの)速さ,調子 / テンポ,速度
tenor	 (…の)趣旨,要旨,大意《+of+名》 / (人生などの)行路,進路《+of+名》
tepid	 なまぬるい(lukewarm) / 熱意のない
thank	 (…のことで)〈人〉‘に'『感謝する,』礼を言う《+名+for+名(doing)》 
thegn	 =thane 
their	 『彼らの』,彼女らの,それらの 
thews	 筋肉 / 筋力,体力
thick	 『厚い』,分厚い;『太い』 / 《数量を表す名詞の後に用いて》『厚さ…の』,太さ…の / (液体・気体が)『濃い』,濃厚な / 『密な』,密生した,密集した / (なまりが)著しい,ひどい / (声が)はっきりしない,かすれた / (頭が)重い,ぼんやりした / 《話》ばかな,愚かな / 《話》親密な;(…と)親して《+with+名》 / 《補語にのみ用いて》(…で)いっぱいの,満ちた《+with+名》 / 『厚く』,分厚く,濃く,密に / 《the ~》(…)最も厚い(太い,濃い,密な)部分《+of+名》 / 《the ~》(活動などの)たけなわ,まっただ中《+of+名》 
thief	 『泥棒』,(特に)こそどろ,空き巣 
thine	 《thouの所有格》なんじの / 《thouの所有代名詞》なんじのもの(yours)
thing	 〈C〉(形のある)『物』,物体;(生物に対しての)『無生物』 / 〈C〉(形のない)『もの』,事,事柄,でき事 / 《複数形で》事情,事態,状勢,状況 / 《複数形で》(すべての)事物,事柄 / 《通例 the~》(努力・活動などの)目的,目標 / 〈C〉衣服,衣類・《one's things》持ち物,所持品,身の回り品 / 《複数形で》道具,用具・〈C〉《親愛・哀れみ・軽べつなどの感情をこめて》人,者,やつ / 《the~》《話》(…の)流行《+in+名》
think	 『…‘を'考える』,心に抱く,想像する,思い描く / …‘と'『思う』,信じる,判断する:《think+that 節…であると思う》 / 『…‘を'企てる』,もくろむ / 《英》…を予期する / 《しばしば think oneself の後に形容詞・副詞[句]を伴って》考えて…の状態にする / 『考える』,思う;思案する,熟考する;予期する / (…について)考えること,一考《+about+名》 / 思考の,思考を促す
third	 《the ~》『第3番目の』,3番目の / 3分の1の / 《the ~》『第3』,3番目[のもの],(月の)『3日』 / 〈C〉『3分の1』 / 〈C〉(音楽で)3度[音程] / 〈U〉(自動車などの)サード(第3速)[ギア] / 第3に,3番目に 
thole	 かい座ビン(ボートのへりにさし込んであるオール受け)　船の櫓べそ　かい受け軸　瓶　栓 
thong	 (サンダルやむちなどに使う)革ひも 
thorn	 〈C〉(植物の)『とげ』,針:No / 〈C〉〈U〉《複合語を作って》とげのある植物
those	 『それ[ら]』,あれ[ら],あの人たち / 《複数名詞の反復を避けて》(…の)『それ』《+of+名》 / 《those who…の形で》(…である,…する)『人たち』 / 『あれらの』,あの,それらの,その / 《those…who(which)…の形で》(…するような,…であるような)『そんな』 
threw	 throw の過去 
throb	 〈心臓が〉『動悸を打つ』,どきどきする;〈傷などが〉『ずきんずきんする』 / (一定のリズムで)反響する,響く / 動悸 / 響く音,鼓動する音
throe	 《おもに文》激痛;(死ぬような)苦しみ;陣痛 / (…とり)苦闘《+of+名(doing)》
throw	 …‘を'『投げる』,ほうる / (…に)…‘を'『投げつける』,〈ミサイル・弾丸など〉‘を'発射する《+名+at+名》 / 《副詞[句]を伴って》〈相手〉‘を'投げ倒す,振り落とす / (…に)〈光・影〉‘を'投げかける,浴びせる,向ける《+名+on(over)+名》 / 〈視線・言葉など〉‘を'投げる,投げかける / 《副詞[句]を伴って》(ある場所・位置・状態に)…‘を'投げ込む;…‘を'急に(…の)状態に落とし込む / …‘を'急いで着る(脱ぐ)《+on(off)+名,+名+on(off)》;(…に)…‘を'さっと掛ける《+名+over+名》 / 《副詞[句]を伴って》〈手・足など〉‘を'ぐいと動かす / 〈声〉‘を'張り上げる;(腹話術で)〈声〉‘を'別の場所から聞こえてくるように思わせる / 〈スイッチ・連結レバー〉‘を'動かす / 〈陶器〉‘を'ろくろにかけて形造る / 〈家畜が〉〈子〉‘を'産み落とす / 《話》〈パーティーなど〉‘を'催す / 《米話》〈試合・勝負事〉‘を'投げる,わざと負ける,八百長で負ける / 《俗》〈人〉‘を'仰天させる,めんくらわせる / 投げる,ほうる / 『投げること』,投球;発射 / 投げて届く距離,射程 / ショール,スカーフ,えりまき 
thrum	 =strum / 〈テーブルなど〉‘を'指でコツコツたたく / =strum / (テーブルなどを)指でコツコツたたく《+on+名》 / 〈大型機械が〉低いうなり音をたてる / つま弾くこと(音);コツコツ[擬声音]
thumb	 『親指』;(手袋などの)親指の部分 / 〈本のページ〉‘を'親指でめくる / 《話》〈ヒッチハイカーが〉〈便乗〉‘を'親指を立てて頼む / ヒッチハイクする
thump	 <人>‘を'『ゴツンとたたく』,『ドンと打つ』 / <こぶし・頭など>‘を'ゴツンとぶつける / (…を)ゴツン(ドン)とたたく《+on(at,against)+名》 / <心臓などが>どきどきする / ゴツン,ドシン,どさっ;ゴツン(ドシン)と打つこと / ゴツン(ドシン)と
thyme	 タイム(ハッカの類の植物;芳香のある葉を香味料にする) 
tidal	 潮の;潮の作用を受ける;潮の干満のある 
tiger	 『トラ』 / トラのようにどう猛な(勇敢な)人
tilde	 スペイン語で n の上につけてる記号（「ニャ」とか「ニョ」といった音を表す）・波形符号、波形ダッシュ・= swung dash 
timer	 (作業・競技などの)時間記録係,計時員 / 秒時計,ストップウォッチ / ある決められた時間に機械,器具などが動くように制御する装置,タイマー 
times	 …掛ける 
tinge	 (…の)『薄い色合い』《+『of』+『名』》 / 『ほんの少し』(の…),(…の)気味《+of+名》 / (…で)…‘を'『薄く色づける』《+名+with+名》 / (…で)…‘に'軽く味(におい)をつける
tipsy	 ほろ酔いの,千鳥足の 
tired	 『疲れた』 / 《補語にのみ用いて》『飽きた』,うんざりした;(…に)飽きた《+of+名(doing)》 / (文句などが)陳腐な 
toady	 おべっか使い,追従者 / (…に)おべっかを通う《+to+名》
today	 『きょう[は]』,本日[は] / 『現代では』,今日では / 『きょう』,本日 / 『現代』,今日
token	 (…の)『しるし』,象徴《+of+名》 / (…の)『記念品』,形見《+of+名》 / (また token coin)代用硬貨(バスや地下鉄などで切符の代りに用いられるもの) / 名(形)ばかりの,ほんのわずかの
tonal	 音の;色調の 
tongs	 ものをはさむ道具,…はさみ 
tonic	 強壮剤;養毛剤,ヘアトニック / (精神的に)元気付けるもの / =tonic water / 主音(音階の中心となる第1音) / 強壮にする,元気付ける / 音調の / (音楽で)主音の 
topaz	 黄玉(おうぎょく);〈C〉(宝石の)トパーズ 
topic	 (…の)『話題』;論題《+of+名》 
toque	 トーク(羽飾りつきの縁なし,または狭い縁つきの小さい婦人帽) 
torah	 (ユダヤ教の)[全]律法 / 《the Torah》モーセの五書
torch	 『たいまつ』 / 《米》(はんだ付けなどに用いる)トーチランプ(《英》blowlamp)・《英》=flashlight・《比喩的に》(…の)火,光,光明《+of+名》・「carry a torch for誰々」または「carry the torch for 誰々」で「誰々に片思いする」
touch	 〈人が〉(手・指などで)…‘を'『さわる』,‘に'触れる《+名+with+名》 / (…に)…‘を'触れさせる,あてがう《+名+to+名》 / 〈物が〉…‘に'触れている,‘と'接触している / …‘を'『感動させる』,の感情を動かす / 《文》〈事が〉…‘に'『影響する』,関係する,かかわる(concern) / 《通例否定文で》〈飲食物〉‘に'手をつける;〈道具など〉‘を'使う / 《しばしば受動態で》(かすかに)…‘に'色合いをつける / (軽く)…‘を'害する,いためる / 《通例否定文で》…‘に'匹敵する,‘と'肩を並べる / 〈船などが〉…‘に'立ち寄る,寄港する / 《俗》《+名+for+名》(金銭などを)〈人に〉‘に'せびる,借りる / さわる,触れる,接触している / (港などに)〈船などが〉立ち寄る,寄港する《+at+名》 / 〈U〉『触覚』,触感 / 〈C〉《単数形で》(物の)感触,手ざわり / 〈C〉『さわる(触れる)こと』,さわられること / 〈U〉《しばしばa ~》(…の)『気味,微候』,気配《+of+名》 / 〈C〉少量,少しばかりの(の…)《+of+名》 / 〈C〉(作品仕上げの)手入れ,一筆 / 〈U〉《しばしばa ~》(作家などの)筆法,作風 / 〈U〉《しばしばa ~》(ピアノ・タイプライターなどの)指運び,たたき方,タッチ 
tough	 (物が)『じょうぶな』 / (肉などが)『堅い』 / (体が)『屈強な』,じょうぶな,(人が)粘り強い,タフな / (法などが)融通のきかない,(人・意志が)がんこな / 『骨の切れる』,やっかいな / 《米》粗暴な / 《話》不幸な,不運な,つらい / よた者,ごろつき,無法者
towel	 『タオル』,手ぬぐい,手ふき / …‘を'タオルでふく
tower	 『塔』,タワー / (…の上に)ひときわ高くそびえる,(力・才能などが)ぬきんでている《+above(over)+名》
toxic	 毒性の,有毒な / 毒による
toxin	 (特にバクテリアの)毒素 
trace	 〈C〉〈U〉(過去に存在した人・物・事件などの)『跡』,形跡,痕跡;(人・動物・車などの通った)跡,足跡《+of+名》 / 〈C〉(…の)かすかなきざし,気味,微量《+of+名》 / 〈C〉(記録計器の描く)線 / …‘の'『跡をつける』,‘を'追跡する,〈足跡など〉‘を'たどる / (…まで)…‘の'由来(起源,原因など)をさかのぼる《+名+back(+back+名)+to+名》 / (複写紙などを使って)…‘を'『[線をたどって]書き写す』 / 〈線・図形〉‘を'『描く』《+out+名,+名+out》 / 〈文字〉‘を'ていねいに書く / '‘を'捜しあてる,見つけ出す / (…に)『さかのぼる』《+back to+名》
track	 《しばしば複数形で》(車・船などの)『通った跡』,(人・動物の)『足跡』 / (人・獣などが通ってできた)『小道』 / 進路,航路 / (行動において)採るべき道,方針,人生航路 / 線路 / (競走のために設けられた)走走路,トラック;《集合的に》トラック競技 / (録音テープの)音帯 / …‘の'『跡をつける』,〈足跡〉‘を'たどる;〈動物〉‘の'臭跡を追う / 〈記録計の針が〉…の進路(軌道)を観察記録する;〈カメラが〉〈被写体〉‘を'追いかけて写す / 〈泥・雨など〉‘の'跡を付ける;〈床など〉‘に'足跡を付ける《+up+名,+名+up》
trade	 〈U〉『商業』,商売 / 〈C〉交換 / 〈C〉〈U〉『職業』 / 〈U〉《the trade》《集合的に》堂業者 / 〈U〉《the trade》…業[界] / 〈U〉《形容詞[句]を伴って》売り上げ高;《集合的に》顧客,得意先 / 《the trades》《話》=trade wind / (…を)『売買する,商う』《+in+名》 / 交換する / (…と)商売を営む,貿易をする《+with+名》 / (人と)〈物〉‘を'『交換する』《+名〈物〉+with+名〈人〉》;(物と)〈物〉‘を'交換する《+名〈物〉+for+名〈物〉》 
trail	 …‘の'『後について行く』(follow) / …‘を'『引きずる』,引きずって行く / 〈人・動物〉の跡をつける,追跡する(pursue) / 〈衣服のすそなどが〉引きずる《+along(behind)》;(…の後を)引きずる《+behind+名》 / 〈人が〉のろのろと(足を引きずるようにして)歩く《+along(behind)》;(…の後を)のろのろと歩く《+『behind』+『名』》 / 〈植物が〉(地面・かきなどを)はう / (試合・競走などで)負けている / 〈雲・煙などが〉たなびく / (動いているものが)後に残したもの(煙・ほこりなど),(長く続く人・車などの)流れ / (人・動物などの)足跡,跡に残したにおい,臭跡 / (荒野などに自然にできた)小道,(踏みなされた)道 
train	 〈C〉『列車』,(練結された)汽車,電車 / 〈C〉(人・車などを長く続く)列,行列 / 〈C〉(衣服の長く引く)すそ,もすそ / 〈U〉〈C〉《集合的に》従者,随員団 / 〈C〉(事件・考えなどの)連続《+of+名》;(事件などの)結果,余波 / 〈C〉(歯車などを数個組み合わせた)列 / 〈C〉遵火線,口火 / 〈人・動物〉‘に'『教え込む』,‘を'訓練する,しつける / 〈専門家〉‘を'養成する / 〈植物〉‘を'整枝する,仕立てる / (…に)〈銃砲・望遠鏡・カメラなど〉‘を'向ける,ねらう《+名+on(upon)+名》 / 訓練を受ける,練習する:《train for+名…に備えて訓練する》
tramp	 《様態・場所などを表す副詞[句]を伴って》『ドシンドシンと歩く』 / (…を)踏みつける,踏みつぶす《+on(upon)+名》 / 《場所を表す副詞[句]を伴って》足を踏みしめて歩く / 《副詞[句]を伴って》…‘を'踏みつける / …‘を'踏みしめて歩く / 〈U〉《the ~,時にa ~》『重い(ドシンドシンという)足音』 / 〈C〉長い徒歩旅行 / 〈C〉浮浪者,ルンペン / (また tramp steamer)〈C〉不定期貨物船 / 〈C〉ふしだらな女
trash	 価値のないもの,役に立たないもの / 《米》廃品,くず,ごみ / くだらない話,駄作,ばかげた考え / 《米》人間のくず,役立たず
trawl	 (また trawl net)トロール網,底引き網 / (また trawl line)《米》はえなわ(多数の釣り針を付けた漁具の一種) / トロール網を引く;《米》はえなわで釣る 
tread	 …‘を'『踏んで通る』,踏みしめて歩く / 《副詞[句]を伴って》…‘を'『踏みつける』,踏んで…にする / 『歩く』,行く / (…を)『踏む』,踏みつける,踏みつぶす《+on(upon)+名》 / 〈U〉《しばしば a~》『踏む(歩く)こと』;歩きぶり,足取り / 〈C〉(階段・はしごの)踏み板,段 / 〈C〉〈U〉(靴の)庭;足の裏(土踏まず以外の部分) / (タイヤ・車輪などの)接地部,踏み面
trend	 (…に向かう)『傾向』,すう勢,流行《+toward+名》 / (川・道路などの)向き / 《方向を表す副詞[句]を伴って》(ある方向へ)〈川・道路などが〉向かう / (ある方向に)〈事態・考えなどが〉向かう傾向がある《+to(toward)+名》
trews	 (スコットランド兵士がはく)細身の格子じまのスボン 
triad	 《まれ》三つ組,三人組 / 三和音/中国（人）の秘密結社
trial	 〈U〉〈C〉『裁判』,公判,審理 / 〈U〉〈C〉(…の)『試験』,ためし《+of+名》 / 〈C〉企て,試み;努力 / 〈C〉(忍耐・徳・信仰などをためす)試練,苦難 / 〈C〉困りもの,迷惑な(やっかいな)人(もの) 
tribe	 《集合的に》《単数・複数扱い》『部族』 / 《しばしば軽べつして》(…の)仲間,集団,連中《+of+名》 / (動植物の)族(family(科)と genus(属)の間の分類単位) 
trice	 瞬間 
trick	 『芸当』,妙技;手品,奇術 / (物事をする)秘けつ,こつ,技,巧みなやり方《+of+名(doing)》・(相手を欺こうとする)『たくらみ』,策略,ごまかし・(特に視覚・聴覚などを欺く) 幻影, 幻覚 / 『いたずら』,悪さ,悪ふざけ・卑劣な(ばかげた,幼稚な)行為 / (態度・言葉などの)癖,習慣《+of+名(doing)・(カードゲームの)トリック(一巡に打ち出された札;通例4枚で得点の基礎となる) ・(船員などの)一交替勤務時間・芸当(曲芸,奇術)の;(映画などの)トリックの・錯覚を起こす,迷わせる・芸当(曲芸,奇術)に用いられる・(体など)よく動かない・〈人〉‘を'『だます』,欺く;〈人〉‘に'手品のトリックを仕掛ける・売春婦のひと仕事・売春婦から見た「客」
tried	 tryの過去・過去分詞 / 試験ずみの;信頼できる
trike	 tricycle 
trine	 3重の,3倍の,3層の 
tripe	 (牛の)第一胃(食用) / 《話》くだらない話(意見,作品など)
tromp	 =tramp 
trope	 修辞[的表現] 
trove	 =treasure-trove 
truce	 休戦,停戦;休戦(停戦)協定 
truck	 『運搬車』,手押し車,トロッコ / 《おもに米》『トラック』,貨物自動車《英》lorry) / 《英》無蓋貨車 / …‘を'トラックで運ぶ(に積む) / トラックを運転する 
truly	 『偽りなく』,心から / まことに,全く(indeed);ほんとうに,実に(really) / 正確に,寸分違わず(exactly) 
trump	 〈C〉(カードの)切り札:play a(one's)trump 切り札を出す / 《複数形で》切り札の組 / 〈C〉《話》りっぱな人,頼りになる人 / 〈札〉‘を'切り札で取る / 切り札を出す 
trunk	 (枝および根と区別して樹木の)『幹』 / (人・動物の)胴体 / 『トランク』旅行用箱型の大型かばん) / 象の鼻 / 《複数形で》(文泳などスポーツ競技用の)男子用パンツ,チランクス / 《米》(自動車後部の)荷物入れ,トランク(《英》boot) / =trunk line 
tuber	 塊茎(ジャガイモのような塊状の地下室茎) 
tulip	 『チューリップ』 / その花;その球根
tumid	 (体の一部などが)ふくれあがった / (言語などが)大げさな,誇張した
tuner	 (ピアノなどの)調律師 / (ラジオ・テレビの)チューナー,同調器
tunic	 チュニカ(古代ギリシア・ローマで男女が用いたひざまである半そでまたはそでなしの上着) / (ゆったりしたそでなしの)チューニック(婦人用スポーツ服,女子学生の制服などに用いる) / 《英》軍人・警官などが制服として着る一種の上着 
twain	 二つ(二人,2個;対) 
twang	 (弦楽器・鉄線などをはじいた時の)鋭く響く音,ブーンと鳴る音 / 鼻にかかった声,鼻声 / …に鋭い振動音を出させる,をブーンと鳴らす / 〈弦などが〉ブーンと鳴る
tweak	 〈耳・鼻〉‘を'つまむ,ひねる / (耳・鼻を)引っ張ること,ひねること
twerp	 くだらないやつ,見下げはてたやつ 
twice	 『2回』,2度 / 『2倍[に]』
twine	 『より糸』,よりひも;麻糸,麻ひる / より合わせ,編み合わせ;からみつき / …‘を'『より合わせる』,編む;(…に)…‘を'より合わせる《+名+into+名》 / (…に)…‘を'からみつかせる《+名+around(about)+名》 / (…に)『からむ』(+around(about)+名》 
twirl	 …‘を'くるくる回す,振り回す / …‘を'ひねくり回す,いじくり回す / くるくる回る / くるくる回すこと;くるくる回すこと
twirp	 =twerp 
tying	 tie の現在分詞 
ukase	 (帝政ロシアの)勅令 / (絶対者・専政者の)命令,布告
ulcer	 潰瘍 
ultra	 極端な,過激な(extreme) / 極端主義者,過激論者
umbel	 散形花序 
umber	 アンバー(黄褐色の天然鉱物顔料) / こげ茶色 / こげ茶色の 
umbra	 本影(日食・月食で太陽光線がさえぎられてできる地球または月の影の部分) / (一般に)影にかった部分,影
umiak	 ウミアック(エスキモーの木製皮張りの舟) 
unbar	 〈戸・門〉‘から'かんぬきを抜く / 《比喩的に》…を開く
uncap	 …‘の'帽子をとる;…‘の'ふた(あおい)を取る 
uncle	 『おじ』 / おばの夫 / 《話》(年輩者に)おじさん,おっさん 
under	 《下方の場所・位置》『…の下に』,に覆われて / 《内部の位置》『…の内側に』,の下に / (重荷・苦痛など)『を負って』,に圧迫されて / (支配・保護・影響など)『…を受けて』,のもとで,の状態で / 《受動状態の継続》『…中』 / (分類項目)『の中に』,に属して / (地位・数量などが)『…に劣る』,より下の / (行動などの基準)に従って,基づいて / 『下へ』,下に / 下位に,抑圧されて,従属して / 下の,下部の;下位の,劣った 
unfit	 《補語にのみ用いて》(物事が)『適当でない』,ふさわしくない / 適任でない,不適格な / (人が)不適当な,欠陥がある / (…に対して)〈人〉‘を'不適当(不適格)にする《+名〈人〉+for+名》
unfix	 …‘を'はずす,緩める / 〈心・気持ち〉‘を'ぐらつかせる
unify	 …‘を'一つにする,統一する,結束させる(unite) / …‘を'同一(一様)にする
unite	 …‘を'『結合させる』,一つにする / (結婚によって)…‘を'結びつける《+名+in+名》 / 〈性質・才能などを〉兼ね備える,あわせ持つ / 結合する
unity	 {U}『単一性,統一性』;{C}単一体,統一体 / {C}{U}(古典劇構成での)一致 / {U}(…との)『協調』,調和《+with+名》 
unrip	 …‘を'切り開く,引き裂く;〈織物・編物など〉‘を'ほどく　明らかにする 
unsay	 〈言ったこと〉‘を'取り消す,撤回する,言わなかったことにする 
unsex	 …‘を'性的能力を奪う,〈特に女性〉‘を'女らしくなくする 
untie	 〈結び目・包みなど〉‘を'解く,ほどく / (…から)…‘の'ひもを解いて放す;(…から)…‘を'放す,自由にする《+名+from+名》
until	 《継続の期限》『…まで[ずっと]』 / 《否定語の後に》『…までは[しない]』,…になって初めて[…する] / 《継続の期限》『…する時まで[ずっと]』 / 《結果》(…して)『ついに』 / 《否定の主節に対して》『…するまでは[…しない]』,…して初めて[…する](before) 
unwed	 (特に女性が)結婚していない,未婚の 
unzip	 …‘の'チャック(ジッパー)を開ける / チャック(ジッパー)が開く
upend	 …‘を'逆さまにする,逆さまに立てる / 《話》〈人〉‘を'やっつける
upset	 『…‘を'ひっくり返す』,転覆させる / 〈計画など〉‘を'『だめにする』,だいなしにする,狂わす / 〈人〉‘の'『心を乱す』,'を'ろうばいさせる / 〈体など〉‘の'調子を狂わせる / 《米》(競技などで)〈相手〉'を'思いがけなく負かす / ひっくり返った / (計画などが)だいなしの,狂った / 《捕語にのみ用いて》(精神的に)混乱した,ろうばいした / (体などの)調子がおかしくなった / 〈U〉〈C〉『転倒』,転落 / 〈C〉(計画.心などの)『混乱』,乱れ;(体の)不調 / 〈C〉《話》けんか / 〈C〉《米》(競技などでの)番狂わせ 
urban	 都市(都会)の / 都市に住む
urine	 尿,小便 
usage	 〈U〉(物の)『用い方』,用法 / 〈C〉〈U〉(言語の)『慣用[法]』,語法
usher	 (教会・劇場などの)『案内人』; (法廷などの)門衛 / 《米》(結婚式の)先導役 / (…へ)…を案内する《+名+to(into, in)+名》 
utile	 有益な,役に立つ 
vague	 (言葉・意味などが)『はっきりしない』,あいまいな / (考え・感じなどが)『ばく然としている』,ぼんやりした / (形・姿などが)『ぼやけた』,はっきりしない / 《名詞の前にのみ用いて》《通例最上級で》《話》ほんのわずかの,かすかな
valet	 (主人の身の回りを世話する男の)従者,従僕 / (ホテルで逆の衣服の世話をする)ボーイ / (スタンド式の)衣服掛け / 従者(ボーイ)として…‘に'仕える / 〈衣服〉‘の'世話をする 
valid	 (理論・理由などが)『妥当な』,しっかりした根拠のある / (契約・法律などが)『合法的な』,正式な手続きを踏んだ / (ある期間,またある条件のもとで)有効な 
valse	 ワルツ,円舞曲(waltz) 
value	 〈U〉(…の)『価値』,値打ち,有用性,重要性《+of+名》 / 〈U〉〈C〉(…の)『価格』,値段《+of+名》 / 〈U〉〈C〉《米》《修飾語句を伴って》(払った金銭に対する)正当な値打ち / 〈C〉(単語の)意味,意義 / 〈C〉値,数値 / 〈C〉音の長短 / 〈C〉色価,(色の)明暗の度 / 〈C〉《複数形で》(道義・倫理などの)価値基準,価値観 / (ある金額に)…‘を'『評価する』,見積もる《+名+at+名〈金額〉》 / …‘を'『高く評価する』,尊重する,重んじる
vapid	 おもしろくない,つまらない 
vasty	 =vast 
vatic	 予言者の,予言的な 
vault	 〈C〉(石・コンクリート・れんがなどでできた)『アーチ型天井』,『丸屋根』,丸天井 / 〈U〉《the ~》《詩》丸天井に似たもの,青天井,大空 / 〈C〉(特に貯蔵用に使われる)『地下室』 / 〈C〉(特に銀行などの)金庫宝,貴重品管理室 / 〈C〉(教会・墓地の)地下納骨堂 / 〈建物など〉‘に'丸天井をつける / 〈建物など〉‘を'丸天井様式にする 
vaunt	 (…を)自慢する,誇る《+of(about)+名》 / …‘を'自慢する,誇る / 自慢,誇り,ほめそやすこと 
vegan	 (肉・魚だけでなく卵・チーズ・ミルクを取らない)菜食主義者 
velar	 (比較変化なし)軟口蓋の / 軟口蓋と舌との接触により発音された / 軟口蓋 / 軟口蓋音
velum	 軟口蓋;(動物の)菌膜;(クラゲの)縁膜 
venal	 (人,人の行為・動機が)金で動かされる,金で自由になる,わいろのきく 
venom	 (ヘビ・サソリ・クモ・ハチなどの)毒,毒液 / 悪意,恨み,憎悪
verso	 (本の)左ページ 
vetch	 ソラマメ,ヤハズエンドウ,カラスノエンドウ 
viand	 《通例複数形で》《大げさに》食物;ごちそう 
vibes	 《通例単数扱い》=vibraphone / 《複数扱い》=vibration
vicar	 (英国国教の)教区牧師(rector以外の牧師でstipend を受ける) / (ローマカトリック教の)司教代理 / 《米》(監督教会の)会堂牧師 / 代理,代理者
video	 〈U〉テレビの映像 / 〈C〉テレビ / テレビ映像に関する / ビデオテープの
vinyl	 ビニール 
viola	 ビオラ(violin と cello の中間楽器) 
viper	 マムシ,毒蛇 / 意地の悪い人
viral	 ウィルスの;ウィルスが原因の 
vireo	 モズモドキ(アメリカ産の小型の鳴鳥) 
virtu	 〈U〉(美術品などの)優秀性,よさ,値打ち / 《集合的に》《複数扱い》美術品,骨とう品 / {U}美術品(骨とう品)に対する造詣(知識) = vertu 
virus	 ビールス,ろ過性病原体 
visor	 (帽子の)まびさし,ひさし / (かぶとの)面頬(顔,特に目を保護するために上げ下げできる部分) / (またsun visor)(車の運転席の)日よけ板 
vista	 通路(街路など)お通してみたながめ,見通し / 予想,展望;追想,回想;
vital	 《名詞の前にのみ用いて》『生命の』,生命に関する(必要な) / 『生き生きしとた』,生気に満ちた,エネルギッシュな / 『きわめて重大な』,肝要な / 『命にかかわる』,致命的な / 生命維持に必要な器官(心臓・肺臓・脳など) 
vixen	 雌ギツネ / がみがみ女
vizor	 =visor 
vocal	 『声の』,音声の / 声に出す,口頭の / 《話》(意見などを)遠慮なくしゃべる,口やかましい / (ポピュラー歌手の)ボーカル
vodka	 ウォッカ(無色透明で穀物やじゃがいもから作るロシアの火酒) 
vogue	 〈C〉(ある時期の)(…の)『流行[品]』,はやり[もの]《+for+名》(fashion) 
voice	 〈U〉(人間の)『声』 / 〈U〉声を出す力,物を言う力 / 〈C〉〈U〉声の質,声の状態(調子) / 〈C〉(人の声を思わせる)(…の)音《+of+名》 / 〈C〉(人の声にたとえた)(…の)音《+of+名》 / 〈U〉〈C〉『発言権』,選択権,投票権 / 〈U〉表現,表明;意見 / 〈C〉(声楽の)声 / 〈C〉(文法で)態 / 〈気持ちなど〉‘を'言い表す,口に出す / 〈音〉‘を'有声音で発音する 
voile	 ボイル(木綿・羊毛・絹・レーヨン製の薄織物) 
vomit	 (胃から)吐く,もどす / 〈煙・灰などが〉吹き出る,吐き出される / 〈胃の中のもの〉‘を'吐き出す / (勢いよく)…‘を'噴出する,吹き出す / 〈U〉吐いた物,嘔吐物 / 〈C〉へどを吐くこと
voter	 投票者;有権者 
vouch	 〈人が〉保証する,請け合う / vouch for it+that 節…であることを保証する / 〈物が〉(…の)保証になる,証明になる《+for+名》 
vowel	 母音 / 《話》母音字 / 母音の 
vying	 vieの現在分詞 
wacky	 気違いじみた,とっぴな 
wader	 水(どろ,雪)の中を歩いて渡る人 / =wading bird / 《複数形で》(釣り人がはく腰まである)防水長靴 
wadge	 (…の)ぎゅっとつめた束《+of+名》　塊（かたまり）　ケーキ一切れ 
wafer	 ウエハース(一種の軽焼き菓子) / (小円形の)封かん紙,封じのり / 聖餐(せいさん)用の薄いパン / (一般に)薄く丸い物
wager	 かけ,かけごと(bet) / かけたもの;かけ金 / かけごとをする,かける / 〈金〉‘を'かける:《wager+名〈金〉+on+名 …に…をかける》
waist	 『腰』,腰部 / (衣服の)『胴部』,ウエスト / (バイオリン・ギターなどの)中央のくびれ 
waits	 (クリスマスの夜,家々を回る)聖歌隊 
waive	 〈権利・主張など〉‘を'自分から放棄する(撤回する) / …‘を'とりあえず見送る(延期する)
waken	 〈人〉‘の'『目を覚まさせる』,‘を'起こす(wake) / 《比喩的に》(…に)…‘を'目覚めさせる,気づかせる,活発にする《+up+名(+名+up)+to+名》
waltz	 ワルツ / 円舞曲 / ワルツを踊る / 〈ダンスのパートナー〉‘を'ワルツでリードする
warez	不法コピーされた商用ソフトウエア  
warty	 いぼ(こぶ)の多い,いぼいぼの 
washy	 (飲み物が)水っぽい,薄い / (色が)薄い,弱い / (感情・文体が)弱い,力のない 
waspy	 スズメバチのような;スズメバチの多い 
waste	 (…に)〈金・時間・路力など〉‘を'『むだに使う』,浪費する《+名+on+名》 / 〈好機など〉‘を'『利用しそこなう』 / 〈体力など〉‘を'『消耗させる』,衰えさせる / 《しばしば受動態で》〈国土など〉‘を'『破壊する』, / 《米俗》…‘を'殺す(kill) / 〈体が〉(だんだん)衰える,やせる,弱る《+away》 / 《まれ》〈物が〉(少しずつ)減る,少なくなる / 〈U〉《時に a~》(…の)『むだ使い』,浪費《+of+名》 / 〈U〉〈C〉《しばしば複数形で》『廃物』,くず,残り物(garbage) / 〈C〉《おもに文》荒野,荒れ地;荒涼とした広がり / 『荒れ果てた』,不毛の:耕されていない;使用されていない / 『廃物の』,くずの,残り物の
watch	 …‘を'『じっと見つめる』,凝視する / …‘を'『見張る』,見守る,監視する,‘の'番をする / …‘を'『世話する』,看護する / …‘に'『注意する』,気をつける / 『じっと見る』,見守る / 『見張りをする』,監視する,警戒する / 《文》夜寝ないでいる;寝ずに看病する / 〈C〉《しばしば複合語を作って》(携帯用の)『時計』, / 〈U〉《時に a watch》『横張り』,警戒,用心 / 〈C〉見張り(監視)時間;〈U〉当直 / 〈C〉《しばしば the watch》番人,看守,警備員 
water	 〈U〉水 / 《しばしば複数形で》『海』(『湖,川』)『の水』 / 《複数形で》流れる水;(海・川・湖などの)波立つ水《+of+名》 / 《複数形で》(特定の)水域,領海,近海 / 〈U〉潮位,水位;《the water》水面 / 〈U〉分泌液(涙・汗・尿など) / 〈U〉溶液,…水 / 《複数形で》(飲用の)鉱泉水 / 〈U〉(織物・金属などの)波紋 / …‘に'『水をかける』(まく,やる) / 〈動物〉‘に'水を飲ませる / …‘に'水を供給する;…‘を'潅漑(かんがい)する / 〈液体など〉‘を'水で割る,薄める《+名+down,+down+名》 / 〈織物・金属など〉‘に'波紋(波模様)をつける / 〈動物などが〉水を飲む:〈船・機関などが〉給水を受ける / 〈目・口などが〉分泌液を出す
waver	 (上下・前後・左右に不安定に)『揺れる』;〈チョウなどが〉ひらひらと動く;〈人が〉よろめく / 〈光などが〉『揺らめく』,ちらちらする;〈音・声などが〉震える / 〈気分・物価などが〉不安定になる;(…と…の間を)揺れ動く《+between+名+and+名》 / 〈人が〉『迷う』,ためらう,たじろぐ
waxed	 ろうを塗った,ろう引きの 
waxen	 ろう製の / ろうのように青白い
weald	 森林地帯 
weary	 『疲れた』,疲れはてた / 人を疲れさせる / 『あきあきさせる』,退屈な / 〈人〉を『疲れさせる』 / (…で)〈人〉‘を'『退屈させる』,うんざりさせる《+名〈人〉+with+名(doing)》 / (…に)疲れる,うんざりする《+of+名(doing)》
weigh	 …‘の'『重さを計る』 / 〈ある重さ〉‘を'『計量する』,計る / (…と比較して)…‘を'『検討する』,考慮する〈+名 against+名〉 / 『重さがある』,目方がかかる / (…にとって)『重要である』,(…に)重要糸される〈+with+名〉 
weird	 起自然的な,不思議な,気味の悪い / 『話』変な,妙な
welch	 =welsh 
welsh	 (人のかけ金・借金を)踏み倒す《+on+名》 / (人の約束を)破る《+on+名》
wench	 (特に田舎の)女の子,娘;淫婦 
whack	 …‘を'ピシッと打つ / ピシッと打つこと,強打;ピシッという音 / 《単数形で》《話》試み / 《単数形で》《話》(公平,平等な)分け前
whale	 鯨: 捕鯨に従事する　〔話〕 非常に大きい［すごい］もの (a ～ at [for, on] …の得意［熱心］な人)
wharf	 波止場,埠頭 
wheal	 (腫れてかゆい)虫さされ,(蚊の)刺し跡 / みみずばれ(=wale)
wheat	 小麦 
whelk	 エゾバイ(食用の巻き貝) 
whelm	 …‘を'水中に沈める / …‘を'圧倒する
whelp	 (犬・オオカミ・猫・ライオンなどの動物の)子供 / 《軽べつして》がき,小僧 / 〈動物が〉子を生む 
while	 《通例 a while》『時間,』間,(特に)少しの時間 / 『…する間に(は)』 / 《譲歩》『…であるが,』…なのに / 《比較・対照》(…だが)『一方では』 / 《類似・対応》そして[その上] / 《英北東部》《俗》…まで(until) 
whine	 〈サイレン・子供・犬などが〉悲しそうな声を立てる,鼻を鳴らす / 泣き言を言う,ぐちをこぼす,だだをこねる / …‘を'哀れっぽい声で言う,だだをこねる;く…である〉‘と'哀れっぽく言う《+that 節》 / すすり泣き,クンクン(ピーピー)いう声 / 泣き言 
whipt	 whip の過去・過去分詞 
whirl	 『ぐるぐる回る』,旋回する,渦巻く / 《方向を表す副詞[句]を伴って》く人・動物などが〉『急に向きを変える』 / 《方向・状態を表す副詞[句]を伴って》〈人・車などが〉『疾走する』 / 〈頭などが〉くらくらする,めまいがする / …‘を'『ぐるぐる回す』,旋回させる,渦巻かせる / 《方向・状態を表す副詞[句]を伴って》…‘を'さっと運ぶ / 回転,旋回;渦《+of+名》 / 〈U〉《しばしば a whirl》(心などの)乱れ,混乱 / 〈C〉《単数形で》(事件・会合などの)めまぐるしい連続《+of+名》 
whisk	 (ちりなどを払う)小ぼうき,毛ぼうき / (針金を輪にして組み合わせた)泡立て器 / 《a whisk》(手・はたきなどの)一払い《+of+名》 / …‘を'さっと払うように振る / …‘を'払い落とす;さっと持っていく《+名+off(away),+off(away)+名》 / 〈卵・クリーム〉‘を'泡立てる / 《方向を表す副詞[句]を伴って》さっといなくなる 
whist	 ホイスト(四人二組に分かれてするカードゲーム;今のブリッジの前身) 
white	 〈U〉『白』,白色 / 〈U〉〈C〉白いもの;(特に)『卵の白身』 / 〈U〉『白衣』,白色の服;《しばしば複数形で》白の制服(運動着など) / 〈C〉白人 / 『白い』,白色の,純白の / (恐怖で人・顔・唇などが)『青白い』,血の気のない(pale) / (皮膚の色の)白い,白人の / (髪・ひげなどが)銀色の,改色の / 雪のある,雪の積もった / 《おもに古》潔白の,罪のない / 《英》(コーヒーが)ミルク入りの / …‘を'白くする,漂白する
whole	 《the ~,one's ~ の形で名詞の前に用いて》『全体の』,全部の,全… / 《名詞の前にのみ用いて》(時間・距離などが)『まる』…,満… / (物が)完全な,欠けていない;《名詞の後に置いて》丸ごとで,ひとかたまりに / 《冠詞をつけずに複数名詞の前に用いて》ひじょうに多くの / 《古》(人が)無傷の,(肉体的に)健康な / 整数の,分数を含まない / 〈U〉《the ~》(…の)『全部』,全体,全量《+of+名》 / 〈C〉完全なもの,統一体
whore	 売春婦(prostitute) 
whorl	 輪生(茎の1点の周囲に3枚以上の葉がつくこと) / (巻き貝の)一巻き / (指紋の)渦巻 
whose	 《疑問代名詞》 / 『だれの』 / 『だれのもの』 / 《関係代名詞》 / 《制限用法》『その』(…する,…した)『ところの』[人,物,事] / 《非制限用法》『そして(しかし)その人の…は(が,お,に)』
widen	 …‘を'広くする / 広くなる
width	 〈U〉〈C〉(幅の)『広さ』,幅,横 / 〈C〉一定の幅のもの(織物)
wield	 《古・文》〈武器・道具など〉‘を'使いこなす,用いる / 〈権力・武力など〉‘を'振るう,行使する
wight	 人,人間 
wilco	 (電波受信で)了解　「will comply」を縮めた言い方 
wimpy	 軟弱な、弱虫の、根性のない、無気力な、野暮ったい、女々しい、駄目な、無能な 
wince	 (恐怖・空痛などに)ひるむ,たじろぐ,すくむ《+at+名》 / ひるみ,たじろぎ
winch	 巻き上げ機,ウィンチ / Gをウィンチで巻き上げる《+up(away)+名,+名+up(away)》
windy	 『風の吹く』,風の強い / 風の当たる,風を受ける / 内容のない,空虚な;おしゃべりな,口数の多い / 《おもに英俗》びくびくした,おびえた
wiper	 ぬぐう人(物) / (車の)ワイパー(=windscreen wiper)
wispy	 一場(束)の,小さな,か細い 
witch	 『女の魔法使い』,魔女,女妖術使い / 醜い老婆,鬼ばば / 魅惑的な女 
withe	 (柳などの)細枝(まきなどを束ねる材料) 
withy	 =withe 
wives	 wife の複数形 
woken	 wake の過去分詞 
woman	 〈C〉(成人した)『女』,女性,婦人 / 〈U〉《冠詞をつけずに》『女性[全体]』,女 / 〈C〉《the womanhood》女らしさ,女性特有の感情(性格,言葉づかいなど) / 〈C〉(主婦の代りに)家事をする女性,お手伝いさん;(女王に仕える)侍女,女官 / 〈C〉《修飾語[句]を伴って》妻,恋人,愛人 
women	 woman の複数形 
wonky	 ぐらぐらする,よろめく 
wordy	 口数の多い / 言葉の
world	 《the world》『世界』,地球 / 《the world》(特定の時代・特徴・地域に限られた)世界,《one's world》(個人の生活・経験などの)世界 / 《the world》宇宙 / 〈C〉(特に生物がいる)天体 / 《the world》『世界の人たち』,世間の人たち / 《the world》『世間』,世の中,現世;《文》世俗,俗事 / 《修飾語を伴って》《the world》(特定のグループの作る)世界,(動植物の生存する)界 / 《a world, the world》大量(の…),たくさん(の…)《+of+名》
wormy	 虫のついた,虫の食った;虫だらけの / 虫けらのような;浅ましい
worse	 (badの比較級)(…より)『もっと悪い』(劣った),いっそう不当な《+than+名(節,句)》 / (illの比較級)《補語にのみ用いて》(病気が)(…より)『もっと悪化した』,さらに悪くなった《+than+名(節,句)》 / (badlyの比較級)(…より)『もっと悪く』;いっそうひどく《+than+名(節,句)》 / いっそう悪いこと,さらに悪化しているもの
worst	 『最も悪い』,いちばんひどい,最悪の / (badly, illの最上級)『最も悪く』,いちばんひどく / 『最も悪い事(物)』,最悪の事態 
worth	 (…するだけの)『価値がある』,(するに)値する《+名(doing)》 / (…の)『値打ちがある』,(…と)同じ価値の《+名》 / (…だけの)財産を持つ《+名》 / (人・物事の)『真価』,価値 / (金銭的な)『価値』,値打ち / (金額相当の)分量 / 富,財産 
would	 《時制の一致により will の過去形として》 / 《単純未来》『…だろう,』でしょう / 《意志未来》『…するつもりである,』しよう / 《過去の想像・推定》『…だったろう』 / 《過去における主語の強い意志・固執》『どうしても…しようとした,』必ず…した / 《過去における断続的な習慣・動作の反復》『…したものだった,』よく…した / 《無生物主語を伴って》《過去における可能性・能力》『…できた』 / 《仮定法条件の帰結節で》 / 《現在の事実に反する仮想》『…だろうに,』なのだが / 《would have+過去分詞の形で》《過去の事実に反する仮想》『…だったろうに,』だったのだが / 《条件節に用いて》…するつもりがある,する意志がある / 《控え目な表現・ていねいな表現として》『たぶん…だろう,』どうも…らしい;《二人称主語の疑問文で》…してください[ませんか] / 《人の特性・癖》『きまって…する,』…するのが癖だ / 《願望を表す動詞の目的語節において》(願わくは)…『であるよう』 / 《文》《願望》『…したい』 / …であればよいと思う(wish)
wound	 windの過去・過去分詞 
woven	 weave の過去分詞 
wrack	 =rack / (岸に打ちあげられた)海草
wrapt	 wrap の過去・過去分詞 
wrath	 憤怒,激怒 
wreak	 (…に)〈復しゅう・暴力・怒りなど〉‘を'与える《+名+on+名》 
wreck	 《しばしば受動態で》〈乗り物など〉‘を'『江破(難破)させる』,破壊する / 《しばしば受動態で》〈人〉‘を'遭難させる / (一般に)…‘を'『だめにする』,台なしにする;取り壊す / 〈U〉(…の)『大破』,破壊,難破;破滅,崩壊《+of+名》 / 〈C〉(乗り物・建物などの)『残がい』 / 〈C〉やせ衰えた人,打ちひしがれた人 / 〈C〉壊れたもの,故障品 
wrest	 (…から)…‘を'ねじ取る,もぎ取る《+名+from(out of)+名》 / (…から)…‘を'力ずくで取る,…‘を'やっとのことで手に入れる《+名+from+名》 / 〈事実・意味など〉‘を'曲げる 
wring	 〈ぬれた物〉'を'『絞る』《+out+名,+名+out》 / (…から)〈水分〉'を'『絞り出す』,絞り取る《+from(out of)+名》 / (人などから)…'を'無理に(努力して)得る《+名+from(out of)+名〈人など〉》 / 〈手〉'を'握りしめる,もみ絞る / 〈首〉'を'強くねじる(ひねる) / 〈心〉'を'深く悲しませる / 絞り,ねじり 
wrist	 手首関節;(シャツなどの)そで口 
write	 〈文字・文章・書物など〉'を'『書く』,記す;〈事〉'を'『書く』,手紙に書く / 〈手紙〉'を'『書く』 / 《話》〈人〉‘に'『手紙をお書く』 / 《通例受動熊で》(書たいように)…'を'はっきりと示す,明記する,刻みつける / 字(文章など)『を書く』 / 『手紙を書く』,便りをする / 〈ペンなどが〉書ける 
wrong	 『正しくない』,間違っている,誤った / (道徳的に)『悪い』,不正の / 『適当でない』,ふさわしくない / 《補語にのみ用いて》(…が)『ぐあいが悪い』,調子が悪い,故障した《+with+名》 / 裏の,逆の / 〈U〉『悪』,不正 / 〈C〉〈U〉『悪事』,不法行為,害 / 『誤って』,間違って / 不正に,悪く / …‘に'悪いこと(ひどいこと)をする;‘を'誤解する
wrote	 write の過去 
wroth	 怒って,激怒して 
wrung	 wring の過去・過去分詞 
wurst	 ソーセージ 
xeric	 乾燥した,湿度の低い 
xylem	 (植物の維管束の)木[質]部 
yacht	 『ヨット』,(大型で豪華な発動機つきの)快走船 / ヨットに乗る,ヨットを走らせる,ヨット競走をする
yearn	 『あこがれる』,慕う,熱望する:《『yearn for』(『after』)+『名』…にあこがれる / (…に)同情する,(…を)気遺う《+over(for)+名》
yeast	 イースト,酵母(パン種・ビール醸造用などに使う) 
yield	 …‘を'『産出する』,生ずる(produce);〈利益など〉‘を'生む / (圧迫・強制などによって)(…に)…‘を'『明け渡す』,放棄する《+up+名(+名+up)+to+名》 / …‘を'譲る,与える / 〈自分〉‘の'身を任せる / 〈土地が〉『作物がてきてる』 / (…に)『屈する』,負ける,従う;(…に)応ずる,譲歩する《+to+名》 / (圧力・力などによって)動く,開く,曲がる,へこむ,壊れる《+to+名》 / 〈U〉〈C〉産出[高],収穫[高]
yodel	 ヨーデル(スイス・チロルの山間地方に行われる地声と裏声を交互に転換しながら歌う民謡;その発声) / ヨーデルを歌う / …をヨーデル調で歌う 
yokel	 田舎っぺ 
yonks	 長期間,長い間 
young	 『若い』,幼い,年の行かない / 『年下のほうの』 / 若々しい,青年らしい(youthful),元気な(vigorous) / 新興の,(歴史の)新しい(new);(季節・時間などの)まだ早い(early);新鮮な,生き生きした / 経験の浅い,未熟な;(…に)不慣れな《+in(at)+名》 / 《通例 the young》《集合的に》若い人たち / 《集合的に》《単数・複数扱い》(動物・鳥の)子,ひな 
yours	 『あなた[たち]のもの』,君[たち]のもの / 《of yours の形で》あなた[たち]の,君[たち]の / あなた[たち]の手紙(家族・責任) 
youth	 〈U〉『若さ』,年の若いこと;若々しさ,元気 / 〈U〉『青年時代』,青春[期];(時代などの)初期 / 〈C〉《しばしば軽べつして》『青年』,若者,(特に)若い男 / 〈U〉《集合的に》《単数・複数扱い》《文》青年,若者たち(young people)
zebra	 シマウマ 
zilch	 ゼロ,無 / とるに足らぬ人間
zloty	 ズローティー(ポーランドのニッケル貨および貨幣単位) 
zonal	 帯の;地域(地区)に分けられた 
